	GenomeID	Taxa	Scaffold_count	GC_content	Fragmented_BGCs	Complete_BGCs	Total_BGCs
0	RDYK01	Nostocales	603	37.84751614482841	20	0	20
1	JAAHHC01	Moorea	131	43.35962862586101	17	15	32
2	CACLPT01	Synechococcaceae	46	30.307529257852188	0	0	0
3	CACNMF01	Prochlorococcus	34	31.840938028595048	0	3	3
4	QCFV01	Prochlorococcus	29	37.08378243520945	0	0	0
5	NETF01	Unicellular	208	36.999542154073744	3	5	8
6	QCIU01	Prochlorococcus	35	29.250799427157236	1	2	3
7	NMQC01	Fischerella	535	40.405871261026554	11	2	13
8	NMQH01	Fischerella	403	40.72380512709178	14	1	15
9	CACFYM01	Prochlorococcus	17	32.95554738935666	0	2	2
10	JNAM01	Prochlorococcus	17	32.33668669132237	2	2	4
11	ALVI01	Kamptonema	114	42.947296130726365	7	10	17
12	JAAHHH01	Moorea	2363	44.019143712248926	45	3	48
13	JAAHGK01	Okeania	1832	36.35289384006316	16	0	16
14	PXQA01	Cyanobacteria	226	48.03575314855305	4	3	7
15	QCFK01	Prochlorococcus	37	35.21620152969069	0	1	1
16	BDGE01	Nostoc	150	40.98911340170426	6	9	15
17	QCIH01	Prochlorococcus	51	31.92378561682019	2	2	4
18	DPNP01	Synechococcales	229	54.71986858206338	2	0	2
19	QCIC01	Prochlorococcus	50	35.53728286282206	3	0	3
20	CACKEF01	Synechococcaceae	47	32.30484609871556	0	0	0
21	CVSY01	Prochlorococcus	221	30.6152702042769	1	2	3
22	JNAP01	Prochlorococcus	10	31.188766762021395	1	3	4
23	ALVT01	Fischerella	34	41.93715178274811	4	17	21
24	CACNSV01	Prochlorococcus	82	30.67180949813317	3	1	4
25	JFKV01	Prochlorococcus	84	30.627509870712238	0	2	2
26	JAAHHU01	Moorea	1789	42.965992267025335	35	7	42
27	CACIIQ01	Synechococcaceae	47	55.86268113213828	0	0	0
28	DKRT01	Cyanobacteria	91	35.05729528827049	0	0	0
29	CACKMQ01	Prochlorococcus	39	31.948268202568798	0	0	0
30	JFLB01	Prochlorococcus	321	31.35311104020519	1	3	4
31	QCPQ01	Prochlorococcus	26	36.85183479956494	2	0	2
32	MWPC01	Prochlorococcus	358	31.04251002114147	1	0	1
33	JAACQX01	Cyanobacteria	332	32.29582126860007	5	0	5
34	QBVT01	Prochlorococcus	28	35.471641677486105	2	0	2
35	QBYW01	Prochlorococcus	36	31.58587423689661	0	1	1
36	LUPS01	Prochlorococcus	152	31.088179108732508	5	0	5
37	CACIAM01	Prochlorococcus	51	31.359420008918644	2	2	4
38	PXVC01	Synechococcus	305	50.421420248380905	9	3	12
39	JMRP01	Cyanobium	71	68.27264803146777	1	6	7
40	JFLI01	Prochlorococcus	332	31.088786543530407	0	0	0
41	QCPL01	Prochlorococcus	53	36.13237075175993	1	3	4
42	QCNJ01	Prochlorococcus	45	32.426773225593585	1	3	4
43	CACOCT01	Prochlorococcus	59	30.343250704114897	2	2	4
44	QBYA01	Synechococcus	41	47.64816346830863	8	1	9
45	CACDRN01	Prochlorococcus	42	31.99495430389429	0	1	1
46	DLGM01	Cyanobacteria	488	53.09055048395929	3	0	3
47	AFXD01	Arthrospira	63	44.82821330934865	2	1	3
48	QBVI01	Prochlorococcus	24	34.789014932874515	0	0	0
49	JFLT01	Prochlorococcus	211	29.916066240810427	1	2	3
50	QCNA01	Prochlorococcus	57	31.979653700067335	3	0	3
51	CACCHB01	Prochlorococcus	28	31.2771873324971	2	1	3
52	CACPHQ01	Prochlorococcus	67	31.999976005093014	0	0	0
53	QCPG01	Prochlorococcus	60	32.119935091589596	3	1	4
54	PVWL01	Cyanosarcina	256	44.80891406546066	10	4	14
55	QCHY01	Prochlorococcus	43	34.62857392939686	0	0	0
56	CABYNM01	Prochlorococcus	32	35.22122802800413	0	0	0
57	PWQB01	Nostocaceae	841	40.874412026558836	4	0	4
58	JAADBR01	Microcystis	279	41.97948817397846	8	3	11
59	CACKZZ01	Synechococcaceae	58	31.00175749111498	0	0	0
60	AAZV01	Leptolyngbya	96	53.114903512885654	0	0	0
61	CACHPH01	Prochlorococcus	62	31.1023028157336	1	2	3
62	DFYB01	Cyanobacteria	63	63.954851901942256	2	2	4
63	QCVT01	Prochlorococcus	56	31.79722826128543	3	0	3
64	CACFFG01	Prochlorococcus	37	31.952623834836274	0	2	2
65	QCGQ01	Prochlorococcus	25	30.910136381702976	2	2	4
66	QCHR01	Prochlorococcus	58	34.711358035499764	3	2	5
67	CACBVY01	Synechococcaceae	53	31.534838078898375	0	1	1
68	ACYB01	Raphidiopsis	47	40.1286036336586	3	5	8
69	RDXL01	Oscillatoriales	155	45.48317618578872	2	4	6
70	PVWG01	Phormidesmis	167	49.04993908334898	4	6	10
71	JAAHID01	Okeania	2450	36.47300093751857	23	0	23
72	PXPM01	Cyanobacteria	247	48.052195405403076	5	2	7
73	JAAHFQ01	Symploca	1266	42.788814747124384	28	0	28
74	DMYK01	Microcoleaceae	643	44.37034532782798	7	0	7
75	JAADBO01	Microcystis	805	42.70446458358272	12	1	13
76	QCVB01	Synechococcus	109	51.844104495264716	4	0	4
77	NHIA01	Cyanobacteria	62	59.92494923260026	2	1	3
78	QCGG01	Prochlorococcus	29	38.92722578113623	0	5	5
79	QCGL01	Prochlorococcus	41	30.97602877597954	0	4	4
80	QCHO01	Prochlorococcus	46	32.27424161321977	2	1	3
81	JAADBD01	Microcystis	326	42.70896522209343	15	2	17
82	QCVI01	Prochlorococcus	48	31.44348291552579	1	1	2
83	CACKZL01	Prochlorococcus	69	31.792732772731767	3	0	3
84	PXPP01	Cyanobacteria	268	47.919312321344144	4	2	6
85	JAAHFZ01	Moorea	204	43.2746640907519	18	16	34
86	DBXD01	Cyanobacteria	96	35.44151777004006	1	1	2
87	JFMN01	Prochlorococcus	314	31.367803485887986	0	2	2
88	ALPL01	Prochlorococcus	92	30.643971500897443	0	0	0
89	QBXP01	Prochlorococcus	24	31.97924498022041	0	0	0
90	QBWX01	Prochlorococcus	41	48.44991740961343	5	1	6
91	CABZRX01	Prochlorococcus	36	32.57225217257006	1	0	1
92	AJLN01	Chlorogloeopsis	161	42.08607190231271	13	8	21
93	JFME01	Prochlorococcus	296	31.302363633008493	1	2	3
94	ALPG01	Prochlorococcus	211	30.763784046336845	0	0	0
95	QCOP01	Prochlorococcus	57	35.92161031408996	2	0	2
96	QCQV01	Prochlorococcus	88	30.935913193800953	2	1	3
97	MNIV01	Cyanobacteria	3215	60.80150317716591	34	0	34
98	JFMS01	Prochlorococcus	351	30.782963646053474	1	0	1
99	FYBH01	Calothrix	472	39.381011240820676	24	2	26
100	DFQU01	Richelia	100	33.321459343918804	2	0	2
101	DQAX01	Synechococcus	212	59.036885388558254	3	0	3
102	CACLYD01	Synechococcaceae	49	30.98181797546993	0	0	0
103	QBWN01	Prochlorococcus	20	45.89446807980521	1	0	1
104	MWOT01	Prochlorococcus	201	31.040897812685305	0	1	1
105	QBXM01	Prochlorococcus	21	31.369497517505064	0	0	0
106	QBWE01	Prochlorococcus	20	34.13257773573568	0	2	2
107	QBXF01	Prochlorococcus	40	30.638033978987302	0	0	0
108	CABYIY01	Prochlorococcus	43	31.861258409373853	0	1	1
109	QCQK01	Prochlorococcus	52	31.864979891721756	1	3	4
110	JFMX01	Prochlorococcus	143	30.8784492686868	1	2	3
111	NHAK01	Fischerella	187	40.51751025501293	10	3	13
112	QCOM01	Prochlorococcus	80	35.84365141543642	3	0	3
113	JAADAF01	Microcystis	549	42.597908665066534	14	1	15
114	QCUK01	Synechococcus	88	54.649845446480725	1	0	1
115	QCDN01	Prochlorococcus	43	31.582663884363885	1	1	2
116	QCKM01	Prochlorococcus	31	40.46087695098874	2	3	5
117	CACIUY01	Synechococcus	19	52.134780713583645	0	0	0
118	QBMC01	Leptolyngbya	299	50.81178657871103	5	2	7
119	QBMH01	Leptolyngbya	407	48.07764847349829	7	1	8
120	CACGRX01	Prochlorococcus	48	31.65675676985333	2	2	4
121	MRCB01	Hydrococcus	68	45.460698713528615	7	7	14
122	NQLA01	Vulcanococcus	160	64.72267750338686	5	6	11
123	NHJC01	Synechococcus	45	63.15609696493482	0	2	2
124	CACNQS01	Prochlorococcus	56	31.282810953159963	0	3	3
125	QCKF01	Prochlorococcus	35	38.760751687092984	1	3	4
126	JAADAM01	Microcystis	802	42.65566605847663	18	0	18
127	QCDS01	Prochlorococcus	56	31.4423374896347	2	1	3
128	LJOT01	Anabaena	1109	39.29406406678638	10	1	11
129	QCUV01	Prochlorococcus	68	31.637586230820343	2	2	4
130	AAVW01	Nodularia	204	41.467827210562206	9	3	12
131	NGZT01	Fischerella	73	40.72902248209887	3	7	10
132	MLAW01	Roseofilum	134	44.60715247236188	1	8	9
133	CACOXH01	Prochlorococcus	50	31.8426233699357	3	2	5
134	AVFZ01	Planktothrix	446	39.11975677109992	9	3	12
135	NJIA01	Cylindrospermopsis	351	40.86822450508662	7	4	11
136	CACOIM01	Prochlorococcus	53	30.51906771384907	1	0	1
137	MTPU01	Cylindrospermopsis	58	40.96775560064943	2	5	7
138	JAADAP01	Microcystis	638	42.58089302221931	16	0	16
139	QCDX01	Prochlorococcus	65	31.626733676161837	1	2	3
140	RFIT01	Cyanobacteria	963	37.86541403963308	4	0	4
141	CACAIX01	Prochlorococcus	47	31.511702810712702	0	1	1
142	QCCL01	Prochlorococcus	36	31.362121935082616	1	2	3
143	JFNZ01	Prochlorococcus	329	30.940031350261908	1	2	3
144	QCRI01	Prochlorococcus	49	31.404261975118125	2	2	4
145	BDSG01	Microcystis	341	41.341667205661565	9	3	12
146	NHBZ02	Synechococcus	110	54.717608063928374	1	5	6
147	QCRB01	Prochlorococcus	51	31.353032193785616	1	2	3
148	QCCG01	Prochlorococcus	36	31.11569450557397	0	4	4
149	QCLD01	Prochlorococcus	89	49.7534014745972	4	5	9
150	JFNQ01	Prochlorococcus	474	30.662784055729666	1	2	3
151	CAIP01	Microcystis	449	42.19240069354396	14	1	15
152	CACBRO01	Prochlorococcus	53	31.39361293100829	1	1	2
153	LURK01	Synechococcus	81	62.835006604988656	5	3	8
154	CACLUE01	Prochlorococcus	44	31.428430760532674	0	1	1
155	MOLZ01	Microcystis	617	41.5433693206375	14	2	16
156	NOXS01	Elstera	35	60.39316537016905	3	5	8
157	QCRT01	Prochlorococcus	69	39.719358798328265	1	0	1
158	LAHI01	Nostoc	712	43.2453566308367	19	6	25
159	CACFBG01	Prochlorococcus	57	35.98382832425897	2	2	4
160	QCCQ01	Prochlorococcus	49	31.947083832526918	1	0	1
161	CACHEM01	Prochlorococcus	30	31.216594898445983	1	1	2
162	QCLR01	Prochlorococcus	64	32.54346406469767	1	2	3
163	JFNG01	Prochlorococcus	231	31.60963204978274	1	3	4
164	CABZQQ01	Synechococcus	52	58.99643898865077	1	1	2
165	QCLY01	Prochlorococcus	61	31.51562682223026	1	1	2
166	JFNL01	Prochlorococcus	409	31.861846766256114	1	1	2
167	CACEHU01	Prochlorococcus	27	32.18881373929655	0	1	1
168	LAHB01	Nostoc	138	41.238276720598506	10	14	24
169	NOXX01	Flavobacterium	228	39.13970248831949	3	1	4
170	CAIM01	Microcystis	782	42.375060736234154	14	0	14
171	NZKA01	Prochlorococcus	68	30.97517227723562	3	0	3
172	CAFN01	Arthrospira	692	44.545452348062774	3	0	3
173	CACOAG01	Prochlorococcus	52	30.329726368665852	1	2	3
174	QCEB01	Prochlorococcus	53	31.503299129321277	1	0	1
175	QCJA01	Prochlorococcus	34	31.17832142088543	4	0	4
176	BJCF01	Dolichospermum	201	38.74539526349535	2	9	11
177	QCTG01	Synechococcus	102	55.31779426948495	5	3	8
178	CACAQP01	Prochlorococcus	63	31.36257190271473	2	1	3
179	NQMF01	Fischerella	1628	40.71347511890073	18	0	18
180	QLKN01	Hapalosiphonaceae	209	40.987835847919094	14	10	24
181	CACGBQ01	Prochlorococcus	66	31.19055662091984	0	0	0
182	QOPR01	Synechococcus	35	55.033533415678235	2	5	7
183	NHDT02	Synechococcus	39	55.791118651350665	1	0	1
184	BDUB01	Nodularia	4	38.132085191503876	3	10	13
185	QCTL01	Prochlorococcus	56	31.628979349469166	1	1	2
186	QCEI01	Prochlorococcus	45	32.91544620921729	0	2	2
187	DNOZ01	Cyanobacteria	435	40.75876003413033	7	1	8
188	QCJJ01	Prochlorococcus	30	36.898435472378196	1	0	1
189	CACMDV01	Prochlorococcus	37	31.90054248131602	2	1	3
190	CACEAS01	Prochlorococcus	45	32.001484754081304	1	0	1
191	MPPI01	Phormidesmis	118	48.63568555076124	3	6	9
192	QCTZ01	Prochlorococcus	36	30.535884793655143	1	1	2
193	PKRP01	Rhizobium	14	59.89229344949397	0	8	8
194	RDZB01	Oscillatoriales	525	44.65617202897927	2	0	2
195	CACITH01	Prochlorococcus	34	35.10636087347016	0	0	0
196	CAQN01	Crocosphaera	1343	37.935275285023316	19	1	20
197	PHFO01	Cyanobacteria	389	49.17812604599459	6	0	6
198	QOPO01	Prochlorococcus	22	30.53401946883345	1	2	3
199	CACGBL01	Synechococcaceae	60	31.48999293750219	3	0	3
200	CACAQF01	Prochlorococcus	26	31.323502918989735	2	1	3
201	CACJQY01	Prochlorococcus	33	31.076829472986248	0	3	3
202	JNBD01	Prochlorococcus	12	36.26041091448558	0	4	4
203	CACKFR01	Prochlorococcus	56	31.727681671912737	1	1	2
204	QCJW01	Prochlorococcus	30	38.115403982118856	0	2	2
205	CACNAG01	Prochlorococcus	69	31.93304813379099	1	1	2
206	CABYLC01	Prochlorococcus	54	31.50535755162573	1	1	2
207	UCNM01	Synechococcus	13	59.15450270182438	0	6	6
208	QCTQ01	Prochlorococcus	47	30.907750959131405	2	1	3
209	LVHP01	Prochlorococcus	26	50.22256869474498	2	10	12
210	QBZH01	Prochlorococcus	45	31.555157573118223	0	0	0
211	AFJC01	Microcoleus	40	46.51389559343407	1	4	5
212	QCSE01	Prochlorococcus	71	31.30681704515659	0	1	1
213	QCMC01	Prochlorococcus	64	31.593305864789148	3	1	4
214	QCBK01	Prochlorococcus	42	31.20389947255771	2	1	3
215	QCMH01	Prochlorococcus	96	30.79708151011555	0	2	2
216	MCIH01	Microcystis	249	43.410161554030125	14	1	15
217	QCSN01	Synechococcus	130	53.050827678854176	3	4	7
218	ACSK03	Arthrospira	268	45.132737641984676	0	2	2
219	PXDR01	Cyanobacteria	643	56.71767461902164	1	0	1
220	QBZC01	Prochlorococcus	69	35.751963639048654	1	3	4
221	CACGJP01	Prochlorococcus	80	32.015769547703286	2	0	2
222	LVHM01	Prochlorococcus	53	48.514753465780664	3	12	15
223	QBZU01	Prochlorococcus	51	30.675566883094955	1	2	3
224	CACHKB01	Prochlorococcus	50	35.03276769101285	1	0	1
225	QCSX01	Prochlorococcus	62	30.667506760964496	1	2	3
226	PBYZ01	Synechococcus	116	49.75107694613105	6	4	10
227	QCSS01	Prochlorococcus	43	31.24593629568397	3	0	3
228	QCBV01	Prochlorococcus	20	31.49971399458807	0	4	4
229	DBCX01	Cyanobacteria	64	46.55967145796153	0	0	0
230	QCTP01	Prochlorococcus	55	30.991018406943777	2	1	3
231	UCNL01	Synechococcus	13	56.474526354099865	1	6	7
232	JNBE01	Prochlorococcus	22	35.74327383053499	0	4	4
233	QCJV01	Prochlorococcus	29	37.21640698537673	0	1	1
234	CACKIP01	Prochlorococcus	65	31.62674438179086	1	2	3
235	CACLBR01	Prochlorococcus	39	31.316958779862205	0	0	0
236	QOPN01	Prochlorococcus	37	35.67441366831037	3	0	3
237	MRBY01	Limnothrix	92	45.22319367815316	1	2	3
238	CACBES01	Prochlorococcus	20	31.031001558953154	1	2	3
239	QBLS01	Pseudanabaena	62	42.94112092091266	1	4	5
240	PKRQ01	Tabrizicola	38	62.75836713488221	1	4	5
241	DMJW01	Cyanobacteria	672	42.70219984149761	17	0	17
242	RFHR01	Cyanobacteria	470	51.153423840904864	6	1	7
243	CABYRO01	Prochlorococcus	20	32.23147775551312	0	0	0
244	QCJK01	Prochlorococcus	52	38.9139820746832	2	5	7
245	CACKFN01	Synechococcus	65	58.73689938851221	1	1	2
246	CACEPA01	Prochlorococcus	62	31.961544836416156	0	0	0
247	QCEH01	Prochlorococcus	15	32.56912882500271	0	1	1
248	ABRV01	Synechococcus	38	48.42711157140288	0	12	12
249	BDUC01	Tolypothrix	66	42.03802037541189	3	15	18
250	QCTM01	Prochlorococcus	94	35.21678814775637	3	1	4
251	CDHJ01	Aphanizomenon	9162	64.00346263028395	4	3	7
252	NJHZ01	Cylindrospermopsis	404	40.84335461786975	8	4	12
253	QOPS01	Synechococcus	30	54.83225978291063	5	3	8
254	SXXM01	Prochlorococcus	123	52.86679731161796	1	4	5
255	RDZU01	Oscillatoriales	462	45.475397055641096	4	4	8
256	CACGMX01	Prochlorococcus	75	31.71822326126089	1	0	1
257	CACAQQ01	Prochlorococcus	56	32.077826638093654	2	0	2
258	CACFDU01	Prochlorococcus	52	31.527262969249787	0	3	3
259	QCTF01	Synechococcus	136	55.536249875667586	2	2	4
260	UCNZ01	Synechococcus	27	52.83630014058654	1	6	7
261	QCEC01	Prochlorococcus	22	32.14870293528263	0	4	4
262	DLUV01	Cyanobacteria	846	43.36937912768773	23	0	23
263	JFOA01	Prochlorococcus	261	31.93773554002556	1	2	3
264	DNGG01	Cyanobacteria	693	44.28429091990815	14	3	17
265	QCBW01	Prochlorococcus	32	31.51890584853502	1	3	4
266	MNZA01	Oscillatoriales	272	44.07165677995709	2	1	3
267	QCSR01	Prochlorococcus	67	32.30489648979762	2	0	2
268	LWAJ01	Nodularia	291	41.64358121826232	9	3	12
269	QCSY01	Prochlorococcus	60	30.61863306737111	2	3	5
270	AGCR01	Tolypothrix	157	40.9381477937026	13	13	26
271	CACHUE01	Prochlorococcus	38	31.461892846143236	2	0	2
272	LYXM01	Synechococcus	95	55.28932910948342	1	17	18
273	CABYZN01	Prochlorococcus	35	32.80775404921708	1	2	3
274	CACEWU01	Prochlorococcus	58	39.42448002687793	2	0	2
275	BAUB01	Synechococcus	44	47.167377408449944	0	4	4
276	QBZT01	Prochlorococcus	35	31.24169631019394	2	0	2
277	NZED01	Synechococcus	63	55.24165942147609	3	6	9
278	LVHL01	Prochlorococcus	12	50.738280296500044	1	10	11
279	DGDG01	Richelia	424	37.047277642449494	16	3	19
280	DOPQ01	Oscillatoriales	541	39.98644246268635	2	0	2
281	AFEJ01	Acaryochloris	511	46.890005740729364	2	7	9
282	CACGER01	Prochlorococcus	47	31.88995571630228	2	2	4
283	QCSO01	Synechococcus	59	55.841504032803556	4	3	7
284	QCMI01	Prochlorococcus	48	31.39452869724079	0	4	4
285	QCBJ01	Prochlorococcus	35	31.062600823087724	1	3	4
286	QCMB01	Prochlorococcus	53	31.610031968933438	2	2	4
287	QCSD01	Prochlorococcus	68	31.956885739165074	2	0	2
288	CABYKV01	Prochlorococcus	80	32.08807585288163	2	1	3
289	CACNFR01	Prochlorococcus	53	31.548051729857793	2	1	3
290	QBZI01	Prochlorococcus	47	32.936444805047635	0	0	0
291	DOPZ01	Nostoc	128	41.27296363466636	6	8	14
292	LVHQ01	Prochlorococcus	26	49.524507651839905	1	10	11
293	CACJYO01	Synechococcaceae	50	31.445610846232952	1	0	1
294	QCKZ01	Prochlorococcus	65	31.250555161977314	2	2	4
295	JSDP01	Aphanizomenon	325	38.33517861779339	8	0	8
296	RFFV01	Cyanobacteria	283	51.72363095101481	4	1	5
297	QCDY01	Prochlorococcus	26	31.37868814205812	0	4	4
298	JAADAQ01	Microcystis	689	42.62834528693326	14	1	15
299	CACGLB01	Prochlorococcus	52	31.60645986574287	1	1	2
300	CACOFD01	Prochlorococcus	40	32.46445409538295	2	0	2
301	SHBS01	Synechococcus	67	61.966443089749966	5	0	5
302	AXAQ01	Mastigocoleus	977	40.3652220448036	32	6	38
303	CACOFO01	Prochlorococcus	66	31.60946197285901	3	0	3
304	NGZU01	Fischerella	76	40.998268929386555	2	9	11
305	DOHO01	Cyanobacteria	556	44.901548774956744	23	0	23
306	QCUW01	Prochlorococcus	68	31.21848912923424	0	1	1
307	JAADAZ01	Microcystis	394	42.708917494541765	13	4	17
308	LJOU01	Anabaena	217	38.754832972395135	10	5	15
309	CACHMM01	Prochlorococcus	55	32.06521867913428	0	2	2
310	QCDR01	Prochlorococcus	59	32.02196590476723	1	2	3
311	JSUH01	Kocuria	67	68.86999231965488	2	7	9
312	CACPBT01	Prochlorococcus	39	31.690472360175608	0	0	0
313	QCUA01	Prochlorococcus	72	30.956090354516416	3	1	4
314	JAADAL01	Microcystis	765	42.73818431248366	17	0	17
315	LGSU01	Hydrocoleum	1501	35.88706782964956	15	1	16
316	QCKG01	Prochlorococcus	43	39.77453029060232	1	2	3
317	CACDIE01	Prochlorococcus	45	37.721634313883065	2	0	2
318	CACOIZ01	Prochlorococcus	47	30.515859058500087	2	3	5
319	JJML01	Neosynechococcus	118	50.777994160493385	4	3	7
320	CZDF01	Planktothrix	209	40.17972721700464	0	9	9
321	MRCC01	Chroogloeocystis	43	42.75873844212833	1	6	7
322	CACOFR01	Prochlorococcus	44	30.590777984693784	3	2	5
323	ANFJ01	Fortiea	5	41.28612556840138	0	10	10
324	CACJPB01	Prochlorococcus	38	31.640923392030423	1	1	2
325	MDZH01	Microcystis	497	39.994047258429035	5	6	11
326	CACMTC01	Prochlorococcus	72	31.661650822297037	1	0	1
327	QCKL01	Prochlorococcus	55	42.2210171970722	1	4	5
328	QCDO01	Prochlorococcus	46	31.87829550063129	0	4	4
329	QCUJ01	Synechococcus	109	56.02386981137714	2	1	3
330	JAADAG01	Microcystis	446	42.61021404684899	17	2	19
331	CAIL01	Microcystis	310	42.254155385074206	3	3	6
332	LAHC01	Nostoc	262	41.410018573836396	15	7	22
333	QCLX01	Prochlorococcus	40	31.44167023370187	2	1	3
334	JFNM01	Prochlorococcus	357	32.03508286250842	1	3	4
335	CACEVR01	Prochlorococcus	60	31.821481084090717	1	0	1
336	QCLS01	Prochlorococcus	32	32.17526392901395	1	2	3
337	JFNF01	Prochlorococcus	335	31.37972795424934	1	2	3
338	QCCP01	Prochlorococcus	36	31.248677189868015	0	3	3
339	QCRU01	Prochlorococcus	64	41.460297545860534	2	0	2
340	LAHH01	Nostoc	789	42.02431408149877	27	0	27
341	DOQK01	Cyanobacteria	21	31.860672863687007	0	0	0
342	ANNX02	Scytonema	86	42.572661497509536	7	23	30
343	LURJ01	Synechococcus	78	62.30721454191857	3	1	4
344	CACLUD01	Prochlorococcus	64	31.141221814962602	2	1	3
345	JAACSJ01	Cyanobacteria	328	32.41962187751085	2	1	3
346	CAIQ01	Microcystis	550	42.23094492724054	12	3	15
347	MRUD01	Synechococcus	46	52.51166174557415	0	6	6
348	QCLE01	Prochlorococcus	58	31.95407539808632	0	3	3
349	JFNP01	Prochlorococcus	205	30.81113572380845	1	2	3
350	QCCF01	Prochlorococcus	20	30.764753357321837	0	4	4
351	JAAANX01	Cyanobacteria	210	43.79662460943208	5	5	10
352	QCRC01	Prochlorococcus	62	31.909604654256093	3	0	3
353	BDSM01	Microcystis	78	42.08231703288005	5	7	12
354	QCRH01	Prochlorococcus	76	31.496615766835106	3	4	7
355	CACMSA01	Synechococcus	60	55.01270676686113	3	1	4
356	QCCM01	Prochlorococcus	25	32.002846939034725	0	2	2
357	CACDJL01	Prochlorococcus	43	32.338771765415096	0	2	2
358	CACBVE01	Prochlorococcus	65	30.915446597400894	3	1	4
359	PXPQ01	Cyanobacteria	302	47.06606136251604	7	1	8
360	QCVH01	Prochlorococcus	69	30.824107745332523	1	0	1
361	CABYNZ01	Prochlorococcus	57	31.534623924944018	0	1	1
362	JAADBE01	Microcystis	337	42.927534187307316	14	3	17
363	QCHN01	Prochlorococcus	34	34.739818036444774	0	4	4
364	NHIK01	Synechococcus	148	60.2589438594666	6	1	7
365	QCGM01	Prochlorococcus	47	30.768845599257418	1	3	4
366	DCQC01	Prochlorococcus	195	50.116182444413575	4	4	8
367	QCGF01	Prochlorococcus	65	39.91124913051522	1	1	2
368	QCVC01	Synechococcus	97	53.31315269388976	4	2	6
369	JPSP01	Candidatus	52	30.49579553100777	0	3	3
370	JAADBN01	Microcystis	1052	42.35441051783704	23	0	23
371	NPIL01	Cylindrospermopsis	166	40.830020002304074	0	8	8
372	AGIK01	Synechococcus	16	50.712855364795786	1	11	12
373	PXPZ01	Cyanobacteria	251	47.88504600603749	6	1	7
374	JAAHFP01	Symploca	245	43.134945520979834	16	10	26
375	PVWP01	Aphanothece	17	69.86663499071085	0	10	10
376	CACAST01	Prochlorococcus	62	31.588377841247254	2	1	3
377	PXPL01	Cyanobacteria	260	47.68251731016475	4	2	6
378	JAAHIE01	Moorea	1451	43.17767151523101	51	4	55
379	PVWF01	Pleurocapsa	249	39.70991830976849	14	2	16
380	QCHS01	Prochlorococcus	55	35.21475911847801	1	2	3
381	ALWD01	[Scytonema	163	41.3466779131867	9	6	15
382	QCGP01	Prochlorococcus	37	31.09535432805629	0	4	4
383	QCVU01	Prochlorococcus	97	31.096705446491693	3	0	3
384	DESZ01	Cyanobacteria	32	33.81843754709389	0	0	0
385	CACNCC01	Synechococcus	54	58.90427462846569	2	2	4
386	JAADBS01	Microcystis	595	42.64832931841469	17	1	18
387	QCHX01	Prochlorococcus	58	35.16652609254226	1	3	4
388	RDXF01	Oscillatoriales	524	44.5911894274082	3	0	3
389	PVWM01	Chroococcidiopsis	917	44.613516108023575	10	2	12
390	MTBS01	Microcystis	163	42.902511272585336	10	4	14
391	JAAHFM01	Symploca	1373	43.10947380571436	40	1	41
392	JFMY01	Prochlorococcus	258	31.715141897247143	1	3	4
393	NHAJ01	Fischerella	270	36.801346128333826	7	5	12
394	QCQJ01	Prochlorococcus	41	31.651370969940217	2	1	3
395	CACLGH01	Prochlorococcus	51	31.669131250499838	2	0	2
396	QBXG01	Prochlorococcus	72	30.97741809715271	2	2	4
397	QBWD01	Prochlorococcus	56	35.102644788357075	4	0	4
398	MWOU01	Prochlorococcus	303	31.189659030782934	0	2	2
399	QBXL01	Prochlorococcus	34	31.136134383841657	1	0	1
400	CACJTI01	Prochlorococcus	56	31.747618975924095	0	2	2
401	JFMR01	Prochlorococcus	167	30.509274826468083	0	4	4
402	NHAA01	Fischerella	123	40.583363104459764	6	7	13
403	QCQW01	Prochlorococcus	75	31.642251291066998	4	0	4
404	ALPF01	Prochlorococcus	58	33.81860110672299	1	0	1
405	JFMD01	Prochlorococcus	411	31.11493197522554	1	1	2
406	QCOQ01	Prochlorococcus	51	34.96666130662956	1	3	4
407	CACLGU01	Prochlorococcus	69	31.605142041814968	3	1	4
408	CACGHI01	Prochlorococcus	85	32.2000010882276	2	0	2
409	NZHI01	Synechococcus	87	58.87155418443699	1	2	3
410	QQWA01	Microcystis	173	42.407890131163946	6	4	10
411	QBXQ01	Prochlorococcus	66	31.103689314063537	1	0	1
412	QBWR01	Prochlorococcus	22	46.53386782991268	1	0	1
413	JFMO01	Prochlorococcus	281	30.57371248283931	0	3	3
414	QCOZ01	Prochlorococcus	42	30.68818204226006	2	2	4
415	CACMAP01	Prochlorococcus	29	31.448222954519714	2	1	3
416	JAAHGW01	Okeania	338	36.71890323989297	19	4	23
417	NTFS01	Calothrix	801	39.047738366629154	6	0	6
418	JAAHHT01	Okeania	562	36.37201866143723	14	6	20
419	LUFH01	Sphaerospermopsis	1429	39.07486870518949	13	0	13
420	CACGAY01	Prochlorococcus	54	31.532487931828186	2	2	4
421	LSZA01	Phormidium	171	55.57202731467255	5	2	7
422	QCIB01	Prochlorococcus	37	31.267457489248507	0	3	3
423	CVSX01	Prochlorococcus	85	31.660125886967464	0	4	4
424	JNAQ01	Prochlorococcus	11	32.09217732451478	0	4	4
425	JFKW01	Prochlorococcus	471	31.74066117957201	0	2	2
426	QCFA01	Prochlorococcus	36	39.71624432546185	0	3	3
427	CACFHT01	Prochlorococcus	36	31.45317225582757	1	1	2
428	JNAZ01	Prochlorococcus	9	35.74480489744927	0	4	4
429	QCFJ01	Prochlorococcus	61	34.85303140107477	3	1	4
430	CACLPH01	Prochlorococcus	61	30.789740806487895	1	0	1
431	APIY01	Dolichospermum	472	37.32663829059987	12	2	14
432	JAAHGJ01	Moorea	1654	41.31336674951006	39	0	39
433	CACIIM01	Prochlorococcus	17	31.077084718323377	0	2	2
434	JAAHHI01	Okeania	3346	36.86263359826425	10	0	10
435	JNAL01	Prochlorococcus	21	31.014283919522228	0	4	4
436	NMQI01	Fischerella	745	40.94839071505788	17	0	17
437	REAI01	Oscillatoriales	348	45.480885969352705	6	1	7
438	QCIT01	Prochlorococcus	53	34.75534002766457	1	2	3
439	JNAG01	Prochlorococcus	8	31.489308395352904	0	4	4
440	NMQB01	Fischerella	937	42.315494632797304	24	1	25
441	CABYQF01	Prochlorococcus	47	31.860218343841797	0	4	4
442	QCFW01	Prochlorococcus	42	35.72656152166574	2	1	3
443	JAAHGA01	Okeania	278	37.396007888472745	15	5	20
444	RDYJ01	Nostocales	271	38.57339063861867	8	1	9
445	ANKQ01	Microcystis	4	42.450047626073086	1	10	11
446	QCPF01	Prochlorococcus	47	30.882184913094704	0	2	2
447	JFLU01	Prochlorococcus	387	31.07070160523699	1	2	3
448	QBVH01	Prochlorococcus	65	35.55961737932849	2	2	4
449	RJVW01	Microcystis	119	42.48168252366189	6	5	11
450	CACGFP01	Prochlorococcus	47	31.90255195911467	3	0	3
451	QCNK01	Prochlorococcus	40	31.042872100045077	0	4	4
452	AZYY01	Aphanizomenon	338	39.22382268871142	9	5	14
453	QCAH01	Prochlorococcus	29	34.9115620602191	1	1	2
454	CACNJX01	Prochlorococcus	72	31.93418803842706	0	1	1
455	QCPM01	Prochlorococcus	39	36.95159383729121	1	3	4
456	CACHYR01	Prochlorococcus	64	34.29825154022476	0	0	0
457	JFLH01	Prochlorococcus	225	31.117812819500053	0	3	3
458	CABZBP01	Synechococcaceae	18	31.24950930705755	0	1	1
459	AXUX01	Synechococcus	3	59.118692202034104	0	1	1
460	CACAKJ01	Prochlorococcus	55	31.662000735046366	2	2	4
461	QBYV01	Prochlorococcus	28	31.41668203161311	1	0	1
462	CACAUG01	Prochlorococcus	72	31.407362710732894	2	0	2
463	CACAKA01	Prochlorococcus	65	32.025389437053704	1	0	1
464	BEIV01	Microcystis	264	41.36720176764191	9	4	13
465	QCPP01	Prochlorococcus	57	35.99205197734864	3	0	3
466	JFLC01	Prochlorococcus	324	31.559289203390254	1	2	3
467	CACPIH01	Prochlorococcus	22	34.805738741982275	1	0	1
468	JFMM01	Prochlorococcus	187	31.23712793211771	0	3	3
469	CABYXI01	Prochlorococcus	54	31.807315814874837	2	1	3
470	QBXS01	Synechococcus	16	51.87631061765712	1	0	1
471	QQWC01	Microcystis	13	43.20769026800302	1	10	11
472	AESD01	Crocosphaera	1126	37.73640792280685	18	1	19
473	CACLYZ01	Prochlorococcus	53	32.22559622565163	3	1	4
474	CACBOU01	Synechococcaceae	55	31.22573993685675	1	1	2
475	PXXO01	Cyanobium	25	61.41379623234983	3	6	9
476	JFMF01	Prochlorococcus	490	30.71000519947725	2	1	3
477	ALPD01	Prochlorococcus	104	30.549646067146146	2	1	3
478	LJZR01	Phormidesmis	136	48.39602487110721	6	3	9
479	QCOS01	Prochlorococcus	79	32.35003161156887	0	0	0
480	AJLM01	Chlorogloeopsis	188	42.45563921572634	13	8	21
481	CACMNZ01	Prochlorococcus	33	31.680107780189488	1	1	2
482	PWYK01	Cyanobacteria	343	38.776265291065435	2	0	2
483	QCQU01	Prochlorococcus	82	30.99363853437429	2	0	2
484	CACHXJ01	Prochlorococcus	70	31.685103254602318	2	0	2
485	LADK01	Trichodesmium	8951	45.27710671539422	12	1	13
486	JFMP01	Prochlorococcus	420	31.542645967466022	2	1	3
487	NHAC01	Fischerella	188	40.6099916858296	9	4	13
488	MWOW01	Prochlorococcus	267	31.889457218986028	2	2	4
489	QBXN01	Prochlorococcus	29	31.81598684681482	1	0	1
490	QBWM01	Prochlorococcus	46	35.01012445651725	1	1	2
491	QBXE01	Prochlorococcus	11	31.36933068667046	0	0	0
492	QBWF01	Prochlorococcus	51	33.97769002349418	0	3	3
493	CACBOC01	Synechococcus	48	56.502564549259176	1	0	1
494	QCQH01	Prochlorococcus	42	31.761780989078744	3	1	4
495	QCON01	Prochlorococcus	73	34.8435821596383	4	0	4
496	NHAH01	Fischerella	106	40.53412592436952	5	6	11
497	BAWS01	Synechococcus	77	47.3584495450084	1	2	3
498	JAAHFO01	Symploca	1461	42.375960140931554	41	3	44
499	NRTA01	Leptolyngbya	222	51.383617124977675	3	6	9
500	CAACVJ01	Hyella	708	37.635515075568726	20	2	22
501	PVWO01	Chamaesiphon	756	45.9514922428934	36	0	36
502	QCHZ01	Prochlorococcus	37	34.74241152164685	1	3	4
503	AJUB01	Oscillatoriales	20	46.36931953649725	2	3	5
504	DESS01	Richelia	406	36.94375052976916	21	0	21
505	PGEM01	Cuspidothrix	243	37.514120054043254	4	3	7
506	JAADBQ01	Microcystis	245	42.28051249712168	6	3	9
507	QCVW01	Prochlorococcus	79	30.776701019298038	3	0	3
508	QCHQ01	Prochlorococcus	45	32.05963574314687	1	3	4
509	QCGR01	Prochlorococcus	24	31.677747713896974	0	5	5
510	ACYA01	Cylindrospermopsis	93	40.07738166196374	2	6	8
511	PVWD01	Filamentous	528	48.714075438789806	9	2	11
512	PXPN01	Cyanobacteria	231	48.020454481599444	3	4	7
513	JAAHIG01	Moorea	776	43.46434472633612	48	8	56
514	PEIG01	Chroococcales	57	43.009033684747706	0	10	10
515	JAAHFR01	Leptolyngbya	1786	48.24183385077111	28	0	28
516	PXPX01	Cyanobacteria	242	47.86270232782635	4	2	6
517	CACBGI01	Prochlorococcus	64	30.928950860756917	1	0	1
518	QCVA01	Synechococcus	119	51.99626907636589	3	0	3
519	CABYAP01	Prochlorococcus	13	34.02281369374341	0	0	0
520	JAADBL01	Microcystis	619	42.63547668188178	15	0	15
521	QCHG01	Prochlorococcus	44	31.94262189491047	1	3	4
522	QCGD01	Prochlorococcus	19	30.807451672108858	0	3	3
523	QCHL01	Prochlorococcus	44	36.11114709769904	2	1	3
524	QCGO01	Prochlorococcus	17	30.755527430223	0	4	4
525	CACKKJ01	Prochlorococcus	32	31.626616213701517	1	2	3
526	NHII01	Synechococcus	69	61.01895019023696	1	2	3
527	QCVJ01	Prochlorococcus	38	31.574367647918884	1	0	1
528	AADV02	Crocosphaera	323	37.06738623420728	9	5	14
529	AJUT01	Microcystis	1905	42.51555855125737	13	0	13
530	SIHH01	Phormidium	537	52.105101597168904	3	2	5
531	JAADBG01	Microcystis	396	42.39953873741735	11	2	13
532	JAAHFY01	Sphaerospermopsis	1027	38.38261883039508	18	0	18
533	PXPS01	Cyanobacteria	208	47.94482364069685	4	2	6
534	RDXR01	Oscillatoriales	178	45.248984774942755	3	3	6
535	CACOER01	Prochlorococcus	13	30.654554380678025	0	1	1
536	JFLA01	Prochlorococcus	206	31.09900907267161	2	3	5
537	QCPR01	Prochlorococcus	105	50.07693063851537	9	3	12
538	DNZA01	Cyanobacteria	830	40.240571074886894	11	0	11
539	CACLFP01	Synechococcaceae	20	31.616390689404987	0	0	0
540	CACAZF01	Prochlorococcus	35	31.45911265150315	0	2	2
541	CACGFD01	Prochlorococcus	52	31.876772256719587	2	0	2
542	DGYA01	Cyanobacteria	146	60.837006968991446	6	3	9
543	LNDC01	Geitlerinema	223	48.64828003352769	6	0	6
544	CACINM01	Prochlorococcus	54	32.02394832375584	1	1	2
545	QCPY01	Prochlorococcus	34	30.946112768708918	0	4	4
546	JFLJ01	Prochlorococcus	232	30.86994061841857	1	2	3
547	SZNH01	Nostoc	106	42.020197124746794	14	11	25
548	CABYYN01	Synechococcaceae	69	30.919391124603294	3	1	4
549	CACEEF01	Prochlorococcus	51	32.07763227728069	1	1	2
550	DMPE01	Planktothrix	521	38.29426372732941	11	0	11
551	QCPO01	Prochlorococcus	36	30.922678020779774	0	3	3
552	LATL02	Limnoraphis	361	41.6836748058307	8	2	10
553	QCNI01	Prochlorococcus	54	31.851157348431055	1	3	4
554	QCAJ01	Prochlorococcus	47	34.99487772679518	1	1	2
555	AXZO01	Synechococcus	2	59.071122432509284	0	1	1
556	DOBT01	Cyanobacteria	270	59.05474932911428	1	1	2
557	CACJUL01	Prochlorococcus	54	31.045314000233606	1	2	3
558	QBVJ01	Prochlorococcus	52	30.67624546699562	2	0	2
559	JFLW01	Prochlorococcus	124	29.1004644329166	0	4	4
560	LWSY01	Nostoc	220	41.21251421219789	10	14	24
561	QCNB01	Prochlorococcus	58	31.73865419121842	2	2	4
562	QCPD01	Prochlorococcus	52	34.7045821417643	0	3	3
563	RDYH01	Oscillatoriales	282	45.84281427925107	2	1	3
564	CACA01	Oscillatoria	377	43.62054806357839	15	3	18
565	CACDDW01	Prochlorococcus	58	31.67908723954236	2	1	3
566	PXQI01	Cyanobacteria	192	48.02517478552912	3	2	5
567	JAAHGC01	Okeania	262	39.71796538447159	12	7	19
568	JYON01	Aliterella	60	44.31000321855746	2	7	9
569	CABZJX01	Prochlorococcus	31	31.719817646327805	0	1	1
570	QCIV01	Prochlorococcus	36	31.032340846905413	1	3	4
571	NHHS01	Synechococcus	97	57.95941892585508	8	1	9
572	QCFU01	Prochlorococcus	26	35.90271672175036	1	4	5
573	ALVJ01	Calothrix	73	38.80301231228942	4	26	30
574	NMQK01	Fischerella	852	40.64945343331468	17	2	19
575	JNAN01	Prochlorococcus	17	32.880999853660896	0	4	4
576	REAK01	Oscillatoriales	245	45.26283953090361	6	0	6
577	AATZ01	Synechococcus	6	54.55508307856715	0	10	10
578	PXQB01	Cyanobacteria	245	47.926169214507226	5	2	7
579	JAAHGH01	Okeania	249	36.910028204739255	14	3	17
580	JAAHHK01	Moorea	2451	43.75173440655437	28	0	28
581	SEBD01	Cyanobacteria	86	31.47712219735372	0	0	0
582	CACIWI01	Prochlorococcus	42	31.470684852298778	0	1	1
583	CACGNS01	Prochlorococcus	46	31.575457230204915	0	3	3
584	FSSI02	Oscillatoria	104	50.46365983547548	4	2	6
585	ANKN01	Prochlorothrix	233	52.56214148257623	4	2	6
586	CACGAP01	Prochlorococcus	25	31.720239516526753	2	1	3
587	QCIK01	Prochlorococcus	43	34.48925615018968	2	2	4
588	JNAX01	Prochlorococcus	20	35.18965663416358	0	4	4
589	QCFH01	Prochlorococcus	42	34.81059266122012	2	1	3
590	CACKJM01	Prochlorococcus	47	31.5294807431528	2	2	4
591	CABYQY01	Prochlorococcus	40	30.126090890068895	0	3	3
592	CACNMX01	Prochlorococcus	47	31.950596693847952	0	1	1
593	QCWF01	Synechococcus	31	57.32278223494907	0	9	9
594	RHLE01	Synechococcus	16	57.126191265723286	0	7	7
595	CVSZ01	Prochlorococcus	93	30.854636559031807	1	3	4
596	ALVW01	Mastigocladopsis	20	43.08991262812579	2	12	14
597	JFKU01	Prochlorococcus	271	31.88553235128671	1	2	3
598	JNAS01	Prochlorococcus	4	35.17170249094635	0	4	4
599	QCFC01	Prochlorococcus	41	38.85251388175642	1	3	4
600	JAAHGU01	Okeania	333	36.69948549428609	21	3	24
601	CACJCK01	Prochlorococcus	57	31.208798351310463	0	2	2
602	DBVH01	Prochlorococcus	207	52.311267662285644	6	0	6
603	DIYT01	Cyanobacteria	106	44.94645313696124	3	10	13
604	QBZK01	Prochlorococcus	46	31.248655366933853	1	0	1
605	LVHS01	Prochlorococcus	27	49.34796395179996	1	11	12
606	CACJYM01	Prochlorococcus	48	31.778176044151035	3	1	4
607	DLDG01	Cyanobacteria	121	36.97223893807583	0	0	0
608	CACLTA01	Prochlorococcus	55	31.183985259221167	1	0	1
609	DKOE01	Prochlorococcus	102	59.15395210510178	3	0	3
610	QCMK01	Prochlorococcus	41	31.643904808544125	0	3	3
611	QCBH01	Prochlorococcus	31	30.877686655100867	2	2	4
612	PBHJ01	Prochlorococcus	17	30.87371014013238	2	0	2
613	QCSM01	Synechococcus	129	56.226182949684166	5	1	6
614	CACMCA01	Prochlorococcus	46	31.79567826249053	0	3	3
615	CACBBE01	Synechococcaceae	53	31.58370049218675	0	2	2
616	FXWN01	Synechococcus	6	46.415906281110956	0	4	4
617	CACAVZ01	Synechococcaceae	36	31.509824874545473	0	3	3
618	CACIBL01	Prochlorococcus	33	30.624879831697346	0	4	4
619	QBZV01	Prochlorococcus	47	30.722407986948294	0	0	0
620	CACAYO01	Prochlorococcus	32	31.22773489543195	2	1	3
621	LVHN01	Prochlorococcus	28	47.967503404435476	1	12	13
622	CACNWH01	Prochlorococcus	49	30.729507658363854	1	1	2
623	LIRE01	Pseudanabaena	770	43.56136253394481	5	0	5
624	QCSP01	Synechococcus	84	58.05779420473756	3	0	3
625	MVDI01	Chroococcidiopsis	74	48.96445455108972	0	7	7
626	DNYC01	Microcoleaceae	607	44.57630025657323	2	0	2
627	DEGZ01	Cyanobacteria	39	33.12398826670063	0	0	0
628	JFOC01	Prochlorococcus	425	31.316568277869038	1	1	2
629	QCBU01	Prochlorococcus	24	31.692358644216814	1	1	2
630	LIRN01	Hapalosiphon	115	41.62949418225898	10	12	22
631	JAAAOK01	Cyanobacteria	432	43.54224853679701	7	0	7
632	NXIB02	Tychonema	271	45.02174033534715	4	0	4
633	DLZW01	Richelia	463	34.29835268490446	4	0	4
634	DLDQ01	Cyanobacteria	43	35.28013120996505	0	0	0
635	QCJB01	Prochlorococcus	51	34.399348985080074	0	3	3
636	PAJY01	Synechococcus	46	58.650846479396435	2	1	3
637	QCEA01	Prochlorococcus	35	31.633734029029164	2	0	2
638	QCTD01	Prochlorococcus	89	31.118578518220104	1	0	1
639	BJCE01	Sphaerospermopsis	680	37.60835570684164	13	1	14
640	CACKWB01	Synechococcaceae	14	30.810143287057866	0	0	0
641	NJHS01	Cylindrospermopsis	465	40.622403038244585	6	4	10
642	NQME01	Fischerella	604	40.254935417001604	16	0	16
643	AUSW01	Psychrobacter	38	43.078854251816814	0	2	2
644	NJHX01	Cylindrospermopsis	501	40.81605051697043	9	2	11
645	QOPQ01	Synechococcus	36	63.07301281512782	0	4	4
646	AUMZ01	Synechococcus	6	52.54380562988917	0	1	1
647	DLLM01	Cyanobacteria	33	31.994972514202022	1	0	1
648	CACEAF01	Prochlorococcus	24	32.22972192205978	3	0	3
649	QCTO01	Prochlorococcus	43	31.323761564344988	1	2	3
650	QCJI01	Prochlorococcus	47	31.080155141681814	1	2	3
651	DNOY01	Cyanobacteria	701	40.260737871847226	7	1	8
652	CACEPC01	Prochlorococcus	20	33.292367082741336	0	0	0
653	LIUQ01	Planktothricoides	165	43.95386672251024	4	5	9
654	QCEJ01	Prochlorococcus	55	32.33825868516157	2	1	3
655	CACCCI01	Prochlorococcus	62	31.812726849260375	2	2	4
656	QCTY01	Synechococcus	122	54.98814609222731	3	1	4
657	RDZA01	Oscillatoriales	341	46.15303828838617	3	0	3
658	PKRS01	Emticicia	39	38.532153935902144	1	4	5
659	JQFA01	Leptolyngbya	13	56.50067943644736	1	4	5
660	CACJOW01	Prochlorococcus	62	31.23364148948028	0	4	4
661	CAQM01	Crocosphaera	918	37.60370992248225	20	0	20
662	CACFZG01	Prochlorococcus	69	31.535742309616072	3	0	3
663	QCJT01	Prochlorococcus	26	42.324435531009925	0	1	1
664	QCEW01	Prochlorococcus	64	35.03367875502595	1	3	4
665	QCTR01	Prochlorococcus	68	31.198977674034012	1	2	3
666	UCNN01	Synechococcus	31	57.03349614517659	1	18	19
667	CACJFG01	Prochlorococcus	32	32.12749041791744	0	1	1
668	CACGKT01	Prochlorococcus	60	31.38948264022724	1	3	4
669	JFNY01	Prochlorococcus	439	31.367219229441226	0	1	1
670	QCCO01	Prochlorococcus	49	31.61014742720232	2	1	3
671	QCRJ01	Prochlorococcus	78	35.21672193834201	1	1	2
672	CACKQL01	Prochlorococcus	38	31.939929296898693	0	0	0
673	QCRA01	Prochlorococcus	67	31.690406566779238	3	1	4
674	LTEC01	Aphanizomenon	67	37.035679264130685	3	5	8
675	NSHT01	Cyanobium	200	63.950512570505964	4	0	4
676	QCLG01	Prochlorococcus	13	31.704752737053926	1	0	1
677	JFNR01	Prochlorococcus	290	32.08051656215327	0	0	0
678	QCCD01	Prochlorococcus	37	31.46008987868744	0	4	4
679	CACIRS01	Prochlorococcus	52	37.171407454659644	3	0	3
680	CACOAY01	Prochlorococcus	45	30.942249743932635	2	1	3
681	CAIS01	Richelia	941	33.708363873800124	3	0	3
682	CACJFL01	Synechococcus	81	50.73646098433234	4	0	4
683	CACGKI01	Prochlorococcus	45	32.02121484800642	1	3	4
684	CACBRZ01	Prochlorococcus	58	31.412548055500146	2	1	3
685	LAHJ01	Nostoc	255	41.370098204035585	19	4	23
686	QCRW01	Prochlorococcus	73	40.989170581857124	2	1	3
687	CABYJE01	Prochlorococcus	56	32.2634148370176	0	4	4
688	JFND01	Prochlorococcus	308	30.81643404383919	1	2	3
689	QCCR01	Prochlorococcus	25	31.939422464217955	0	3	3
690	QCLZ01	Prochlorococcus	24	30.538699608537343	2	2	4
691	JFNO01	Prochlorococcus	238	30.938355701097677	2	1	3
692	RSCJ01	Chlorogloeopsis	85	42.29669562687306	8	12	20
693	LAHA01	Nostoc	131	41.058702983879925	9	13	22
694	DFRI01	Prochlorococcus	273	51.64447611685016	12	3	15
695	BFAC01	Microcystis	206	40.0739288099046	1	10	11
696	CAIN01	Microcystis	479	41.90669052010341	13	3	16
697	QCUH01	Synechococcus	95	55.39628341772498	4	3	7
698	JAADAE01	Microcystis	250	42.002433013463495	10	2	12
699	CACHST01	Prochlorococcus	56	32.111221814463015	2	1	3
700	QCKN01	Prochlorococcus	47	41.17470675658949	1	1	2
701	RFFB01	Hormoscilla	70	47.53115926072714	11	7	18
702	QCDM01	Prochlorococcus	39	31.45426535221267	2	2	4
703	CACHMR01	Prochlorococcus	48	32.280706505536756	2	0	2
704	DJOE01	Cyanobacteria	24	31.9231022204897	1	0	1
705	NYXI01	Synechococcus	51	57.11658348339009	3	2	5
706	MRCA01	Fischerella	34	41.29061442212317	2	12	14
707	CACBKH01	Prochlorococcus	65	31.44120519276009	1	1	2
708	QBMK01	Pseudanabaena	60	42.11265653895603	0	3	3
709	LNAA02	Oscillatoriales	68	54.13043550421902	1	8	9
710	CACMTJ01	Prochlorococcus	39	31.24100655241651	2	2	4
711	QCKE01	Prochlorococcus	38	34.81350939053923	0	3	3
712	QCDF01	Prochlorococcus	23	32.108351092109295	2	1	3
713	QCUC01	Prochlorococcus	56	31.581665171143104	1	0	1
714	JAADAN01	Microcystis	644	42.54598048887582	18	0	18
715	CACKHU01	Synechococcaceae	42	31.697615270158728	2	0	2
716	CACHMO01	Prochlorococcus	12	32.41250976457177	0	1	1
717	QCDP01	Prochlorococcus	36	31.204846365174078	0	2	2
718	QCUU01	Prochlorococcus	75	31.89027871380303	4	0	4
719	JAADAX01	Microcystis	596	42.90010263728804	16	1	17
720	LJOW01	Aphanizomenon	1160	44.3425520125604	10	2	12
721	AVFY01	Planktothrix	235	40.36765500811066	8	1	9
722	NGZW01	Fischerella	197	40.40434910523226	12	1	13
723	MTAX01	Nostoc	149	41.92006450820398	9	13	22
724	CACDFY01	Prochlorococcus	16	32.30184689570286	1	1	2
725	CBZS01	Richelia	857	39.00083347381704	3	0	3
726	ABSE01	Cyanobium	18	67.86165652877442	2	7	9
727	JAADAS01	Microcystis	774	42.86329337046203	17	0	17
728	UCOB01	Synechococcus	35	57.29557958543052	0	11	11
729	NAPS01	Westiellopsis	29	40.97031000548719	4	17	21
730	CAIO01	Microcystis	809	42.46423448209237	19	1	20
731	AUZM01	Lyngbya	438	41.37020642884013	7	0	7
732	CZCZ01	Planktothrix	13	39.341868251832224	1	8	9
733	CABZOU01	Synechococcaceae	27	31.159365203786358	1	1	2
734	CABYEL01	Prochlorococcus	14	36.22084087057802	0	0	0
735	RSCK01	Chroococcidiopsis	295	44.74835834211029	9	4	13
736	QCCX01	Prochlorococcus	42	31.39672678811502	1	3	4
737	CACHJG01	Synechococcaceae	28	31.41639604605358	1	0	1
738	PQWO01	Acaryochloris	72	48.95869512768433	6	11	17
739	JFNN01	Prochlorococcus	309	30.573108819801437	1	2	3
740	QCCS01	Prochlorococcus	38	31.51541722207202	2	2	4
741	JFNE01	Prochlorococcus	426	31.367580336643965	1	2	3
742	QCRV01	Prochlorococcus	45	39.16516220967272	2	1	3
743	MOLN01	Microcystis	413	42.054970786625006	11	3	14
744	PVMC01	Cylindrospermopsis	89	39.938232004816484	3	6	9
745	PXEJ01	Cyanobacteria	431	36.22599964991234	1	0	1
746	CACOAN01	Prochlorococcus	68	30.246733532448644	1	2	3
747	NQKW01	Synechococcus	84	61.32757648595178	0	7	7
748	CACAWW01	Prochlorococcus	54	31.869043191466766	3	0	3
749	QCCE01	Prochlorococcus	25	31.665769057534376	1	3	4
750	DEFJ01	Cyanobacteria	34	32.88779557890218	1	0	1
751	QCLF01	Prochlorococcus	95	50.52885543219296	9	0	9
752	JFNS01	Prochlorococcus	338	31.77014184637613	3	1	4
753	CACMBG01	Prochlorococcus	44	32.016453904107976	1	1	2
754	QCRK01	Prochlorococcus	56	30.76963476248896	2	1	3
755	QCCN01	Prochlorococcus	35	30.75915921511707	1	2	3
756	JFNX01	Prochlorococcus	218	30.880185619964106	1	2	3
757	CAIY01	Richelia	90	33.86626766811206	0	2	2
758	CZCT02	Planktothrix	151	40.37289862038591	2	9	11
759	JTHE01	Lyngbya	298	40.94064272234989	0	4	4
760	AEPQ01	Moorea	287	45.030818126813216	20	15	35
761	QCDZ01	Prochlorococcus	31	31.50120668389466	0	3	3
762	QCKY01	Prochlorococcus	36	32.23518058278706	0	3	3
763	JAADAR01	Microcystis	674	42.896825249860306	15	1	16
764	CABYMM01	Prochlorococcus	68	31.50240028746673	0	0	0
765	AJYB01	Planococcus	160	43.19210134560645	0	4	4
766	CACBKT01	Prochlorococcus	48	31.613677165922656	3	0	3
767	AVFS01	Planktothrix	349	40.45451345395117	5	3	8
768	NGZV01	Fischerella	109	39.88167031215808	3	6	9
769	AVFX01	Planktothrix	171	41.424927456744925	5	4	9
770	JAADAY01	Microcystis	268	42.34900916621567	11	2	13
771	LJOV01	Anabaena	1227	41.98963722332954	18	0	18
772	AAVU01	Lyngbya	110	41.2921165502407	0	2	2
773	QCUT01	Prochlorococcus	68	30.78390325853649	4	0	4
774	JMIX01	Erythrobacter	22	60.00516707133906	1	1	2
775	QCDQ01	Prochlorococcus	25	31.046771688661785	0	1	1
776	JAADAO01	Microcystis	684	42.75974854955034	19	1	20
777	QCUB01	Prochlorococcus	70	30.75396993712644	2	2	4
778	QCDG01	Prochlorococcus	28	31.496239902569634	0	3	3
779	QCKD01	Prochlorococcus	27	37.49445588466848	0	0	0
780	QBMJ01	Leptolyngbya	476	58.253856618140034	1	1	2
781	QCDL01	Prochlorococcus	52	31.831206467172176	1	3	4
782	RFFC01	Hormoscilla	64	45.29660356708765	0	0	0
783	QCKO01	Prochlorococcus	35	35.304635524404944	1	2	3
784	JAADAD01	Microcystis	586	42.74450023585312	18	0	18
785	CACMJF01	Prochlorococcus	21	33.07039501854944	0	1	1
786	QCUI01	Synechococcus	107	54.63993069421691	19	6	25
787	CACGTI01	Synechococcus	25	58.911538759775965	1	0	1
788	CACGEL01	Prochlorococcus	61	31.325905801925035	1	1	2
789	CABYUE01	Synechococcaceae	47	31.421202850669122	1	0	1
790	LIRO01	Limnothrix	143	55.937652296195196	1	2	3
791	QCBT01	Prochlorococcus	51	31.18394810652294	1	3	4
792	JFOB01	Prochlorococcus	442	31.6207003683896	1	0	1
793	CACKPW01	Prochlorococcus	24	30.932050485507336	2	2	4
794	CACHUM01	Prochlorococcus	54	32.20289215918838	1	2	3
795	CACCZQ01	Prochlorococcus	35	30.511487871089074	1	2	3
796	QCSQ01	Prochlorococcus	56	30.997661630847432	3	2	5
797	CACFCB01	Prochlorococcus	76	33.73376353203942	2	1	3
798	QCSZ01	Prochlorococcus	88	31.246143342380286	2	0	2
799	CACEFS01	Prochlorococcus	62	31.532506145093784	2	1	3
800	CACHDC01	Synechococcaceae	70	31.63366241913774	3	0	3
801	ADXM01	Synechococcus	78	61.66014955296536	4	6	10
802	LVHO01	Prochlorococcus	27	48.31452574186889	2	10	12
803	CACBSA01	Prochlorococcus	52	31.308943403507786	0	1	1
804	CACJVD01	Synechococcus	96	57.720818364423764	3	1	4
805	QBZA01	Prochlorococcus	11	35.58337927811598	0	0	0
806	CACAYX01	Prochlorococcus	49	31.926913985086504	2	1	3
807	RHGL01	Leptolyngbya	187	50.99312370980345	7	7	14
808	QCSL01	Synechococcus	100	56.60159603637762	7	2	9
809	QCBI01	Prochlorococcus	25	32.23204672944911	2	2	4
810	QCMJ01	Prochlorococcus	74	32.08751184090405	1	2	3
811	QCMA01	Prochlorococcus	53	31.50969930671555	2	1	3
812	CACNFQ01	Prochlorococcus	61	31.794921059264937	2	1	3
813	LVHR01	Prochlorococcus	34	48.801982487298034	1	15	16
814	QBZJ01	Prochlorococcus	62	31.164518492966373	0	0	0
815	CACNNF01	Prochlorococcus	18	31.689233892264497	2	0	2
816	QCTS01	Prochlorococcus	44	31.520517599557085	0	1	1
817	QCJU01	Prochlorococcus	31	31.469953761625643	1	1	2
818	CACAQD01	Prochlorococcus	54	31.72946991042812	1	3	4
819	RDZK01	Oscillatoriales	186	45.52830361956053	2	4	6
820	CAQL01	Crocosphaera	1266	38.021838938897815	23	0	23
821	CACJOV01	Prochlorococcus	57	32.191729840311005	0	2	2
822	MRBZ01	Nostoc	320	41.32279329757616	22	4	26
823	PKRR01	Uliginosibacterium	23	58.78706942371868	0	4	4
824	CACHRD01	Prochlorococcus	34	31.61088221188462	0	1	1
825	UCND01	Synechococcus	17	58.29420461197807	0	6	6
826	AJWF01	Anabaena	13	38.89330845929152	0	12	12
827	CABYLJ01	Prochlorococcus	77	35.2970923558792	1	0	1
828	QCTX01	Synechococcus	49	56.147498894743855	2	2	4
829	QCEK01	Prochlorococcus	32	30.820022879089706	2	2	4
830	CABYRZ01	Synechococcaceae	64	31.22282605553918	3	0	3
831	PAEP01	Synechococcus	55	57.603085162471835	0	2	2
832	DCSN01	Pseudanabaena	259	42.444254771709815	1	2	3
833	QCJH01	Prochlorococcus	44	39.2894788927773	3	5	8
834	UCNR01	Synechococcus	18	59.96123446670372	0	6	6
835	CABZFE01	Prochlorococcus	54	31.726680198468234	2	1	3
836	QCTN01	Prochlorococcus	54	31.278475527667606	4	1	5
837	QOPP01	Synechococcus	45	63.51566356900421	2	7	9
838	CACGSV01	Synechococcaceae	32	32.068189175397464	0	0	0
839	NJHY01	Cylindrospermopsis	351	41.00870745204169	7	5	12
840	CACBEF01	Prochlorococcus	30	31.302805892556368	1	1	2
841	JAACUG01	Cyanobacteria	142	32.499964881748895	0	3	3
842	PKRO01	Porphyrobacter	105	62.69540704797427	3	1	4
843	NQMD01	Fischerella	1820	40.851360155920936	26	0	26
844	MTQM01	Microbacterium	9	68.85132158262999	1	3	4
845	CACENO01	Prochlorococcus	49	38.616660507579425	0	2	2
846	CACNAS01	Synechococcus	43	54.28204015910472	0	1	1
847	CACMDI01	Prochlorococcus	50	31.571311070294186	2	0	2
848	BJCD01	Planktothrix	193	39.684340542328705	5	5	10
849	QCTE01	Synechococcus	93	55.78239498683078	5	3	8
850	QCJC01	Prochlorococcus	35	33.8976974060551	0	6	6
851	BDQK01	Aphanothece	20	36.638956690413906	1	10	11
852	QCPE01	Prochlorococcus	52	42.25607135129251	1	0	1
853	JFLV01	Prochlorococcus	231	31.74666740359433	0	0	0
854	QCNC01	Prochlorococcus	31	30.672405656150733	2	2	4
855	NGAA01	Fischerella	100	40.34647798298096	3	8	11
856	CACGFX01	Synechococcaceae	67	31.883814463605443	1	2	3
857	QBVK01	Prochlorococcus	48	30.315819976171337	1	0	1
858	ASZQ01	Microcystis	278	42.062130557866766	11	4	15
859	QCAK01	Prochlorococcus	33	35.650366642616476	0	0	0
860	QCNH01	Prochlorococcus	71	31.507713340504786	2	0	2
861	DMPD01	Cyanobacteria	373	58.69390203060378	2	0	2
862	QCPN01	Prochlorococcus	62	37.47239304008698	1	2	3
863	CABZBE01	Prochlorococcus	74	32.439184453264694	1	0	1
864	JFLK01	Prochlorococcus	281	31.99795749387389	1	3	4
865	CACHVD01	Prochlorococcus	30	32.04174592897922	0	2	2
866	QCPX01	Prochlorococcus	33	31.01834864133615	0	3	3
867	CABYGI01	Prochlorococcus	33	31.66978810768153	1	1	2
868	CACINL01	Prochlorococcus	49	31.881647637269104	1	1	2
869	QBYU01	Prochlorococcus	20	34.80286419164311	0	0	0
870	CACLFQ01	Prochlorococcus	49	31.665820109762535	2	1	3
871	BEIU01	Microcystis	88	42.133156256951345	2	11	13
872	MWPA01	Prochlorococcus	234	31.00565001552144	2	0	2
873	CACNEE01	Prochlorococcus	21	32.06547805417146	2	0	2
874	ABYK01	Arthrospira	129	45.04718272723283	2	0	2
875	DEDY01	Cyanobacteria	47	32.158317005666824	1	0	1
876	JAAHHW01	Moorea	510	43.22194811659474	13	10	23
877	JAAHGT01	Okeania	1512	35.96749215593961	20	0	20
878	QCFB01	Prochlorococcus	47	40.443072473132204	1	4	5
879	QCIA01	Prochlorococcus	57	35.71262696687927	1	1	2
880	JFKT01	Prochlorococcus	173	31.21284213308228	1	2	3
881	JNAR01	Prochlorococcus	17	31.661454208016508	1	3	4
882	CACKJL01	Prochlorococcus	61	31.660071872420517	1	0	1
883	QCFI01	Prochlorococcus	65	38.47951492379887	4	1	5
884	QCIJ01	Prochlorococcus	48	32.302213924660684	1	2	3
885	JNAY01	Prochlorococcus	19	36.26085489814816	0	4	4
886	ANKO01	Oscillatoria	253	53.42013282432073	6	10	16
887	CACDDK01	Prochlorococcus	36	31.169348023179964	0	2	2
888	RDYB01	Oscillatoriales	239	45.83007712898363	4	0	4
889	APIZ01	Dolichospermum	372	38.0044421759452	15	1	16
890	DOJB01	Cyanobacteria	451	40.57985865749061	7	1	8
891	JAAHHJ01	Symploca	289	44.972131232718354	4	14	18
892	PXQC01	Cyanobacteria	266	48.09070832122601	4	1	5
893	JAAHGI01	Symploca	686	46.23420213947828	14	12	26
894	CABZEQ01	Prochlorococcus	9	31.45156974709772	0	1	1
895	ALVK01	Pseudanabaena	28	50.015056129738625	0	8	8
896	JNAO01	Prochlorococcus	16	31.879138005411257	0	4	4
897	NMQJ01	Fischerella	873	40.2474915221138	20	0	20
898	REAA01	Oscillatoriales	668	45.47536163734939	7	2	9
899	QCFT01	Prochlorococcus	53	35.8272491138345	2	1	3
900	QCIW01	Prochlorococcus	47	36.23514951036627	1	5	6
901	CACNSB01	Prochlorococcus	34	31.729470671174546	1	1	2
902	NMQA01	Fischerella	383	40.76647260847378	13	4	17
903	DMXX01	Cyanobacteria	20	29.033598170302334	0	0	0
904	CACNMD01	Prochlorococcus	28	32.27573738277203	1	0	1
905	JAAHHA01	Okeania	4052	39.056475876572854	23	0	23
906	NZPI01	Synechococcus	49	58.00790542625545	6	7	13
907	PXQH01	Cyanobacteria	69	64.30222772954636	0	2	2
908	JAAHGB01	Okeania	191	36.76556386325164	11	7	18
909	CACARF01	Prochlorococcus	35	31.19808446070301	0	0	0
910	RDYI01	Oscillatoriales	475	44.53932610586149	2	1	3
911	JFMZ01	Prochlorococcus	136	31.40774929048368	0	4	4
912	QCOO01	Prochlorococcus	64	51.20261047676758	8	1	9
913	NHAI01	Fischerella	119	41.00086491045206	6	5	11
914	CABZLA01	Prochlorococcus	58	31.62041831619034	1	3	4
915	QCQI01	Prochlorococcus	59	31.86905965527643	2	0	2
916	QBWG01	Prochlorococcus	36	35.359968210334515	1	1	2
917	CACJTA01	Prochlorococcus	52	31.57192209375247	2	0	2
918	QBWL01	Prochlorococcus	60	35.05588496099054	3	1	4
919	CACATU01	Prochlorococcus	34	30.970753156552433	0	0	0
920	MWOV01	Prochlorococcus	198	31.126354762051204	1	2	3
921	CACGVZ01	Prochlorococcus	50	31.356553335491668	0	3	3
922	JFMQ01	Prochlorococcus	325	31.294333197897533	1	0	1
923	DEEH01	Cyanobacteria	22	36.55443417954177	0	0	0
924	NHAB01	Fischerella	128	40.89478285821163	5	7	12
925	CACCIG01	Prochlorococcus	32	31.902878923996916	1	1	2
926	CACFAG01	Prochlorococcus	43	31.25426256144965	1	3	4
927	QCQT01	Prochlorococcus	53	35.510817423430886	2	1	3
928	AJLL01	Fischerella	141	41.36924814530337	8	6	14
929	ALPE01	Prochlorococcus	109	31.529924174945076	2	0	2
930	JFMG01	Prochlorococcus	377	30.84593826536634	2	1	3
931	QCOR01	Prochlorococcus	37	30.94130825049482	2	0	2
932	QBWZ01	Prochlorococcus	31	46.95055568156409	4	3	7
933	DDLS01	Cyanobacteria	210	44.84360958322059	11	6	17
934	QQWB01	Microcystis	96	42.9858762913919	4	8	12
935	CACOMD01	Prochlorococcus	53	30.559916705509494	2	2	4
936	QBXR01	Prochlorococcus	48	31.49261442687494	1	0	1
937	CACNUL01	Prochlorococcus	61	32.10695442709468	2	1	3
938	JFML01	Prochlorococcus	255	30.940777926352933	0	4	4
939	QCOY01	Prochlorococcus	16	35.22450492977798	0	0	0
940	CACLQL01	Prochlorococcus	48	30.714807475471172	1	0	1
941	JAAHFX01	Sphaerospermopsis	38	38.60578824892978	3	8	11
942	CACBGC01	Synechococcaceae	83	31.97613300039464	1	0	1
943	PXPR01	Cyanobacteria	241	48.0955871716305	5	2	7
944	PULD01	Cyanobacteria	399	55.2401642128529	7	1	8
945	AJUU01	Microcystis	1894	42.410862098432794	12	0	12
946	JAADBF01	Microcystis	426	42.44730204890708	6	6	12
947	QCVK01	Synechococcus	93	53.329872165233304	5	5	10
948	QCGN01	Prochlorococcus	52	30.10818752418587	1	3	4
949	QCHM01	Prochlorococcus	41	34.82984950646081	1	4	5
950	QCGE01	Prochlorococcus	37	39.30553377172914	2	3	5
951	JAADBM01	Microcystis	622	42.60196602275197	15	0	15
952	AAUA01	Synechococcus	4	59.55420151906696	0	16	16
953	JAAHFS01	Kamptonema	331	41.86779421552383	16	4	20
954	PXPY01	Cyanobacteria	239	47.998606281469385	7	0	7
955	LMVE01	Cylindrospermopsis	136	39.79026808375971	3	6	9
956	RDXX01	Oscillatoriales	163	45.48415984496282	0	7	7
957	LUGL01	Elainella	284	47.629797457367374	6	3	9
958	CACOEX01	Prochlorococcus	56	29.349123237272774	1	4	5
959	JAAHIF01	Moorea	3477	43.58004375695873	34	0	34
960	PXPO01	Cyanobacteria	272	47.938290261124685	5	2	7
961	ASSJ01	Rubidibacter	99	55.74606541142364	9	3	12
962	CACIYG01	Prochlorococcus	50	34.7720688881695	2	0	2
963	PVWE01	Filamentous	1156	48.38094589811733	2	0	2
964	QCGS01	Prochlorococcus	49	34.97484107585415	1	4	5
965	QCHP01	Prochlorococcus	59	34.83161840903871	3	2	5
966	QCVV01	Prochlorococcus	83	31.020681873408165	2	3	5
967	JAADBP01	Microcystis	257	42.53923934847426	6	3	9
968	CACKZX01	Prochlorococcus	56	31.50657511427466	4	0	4
969	PYVJ01	Cyanobacterium	232	38.74945289160157	0	0	0
970	SHAR01	Prochlorococcus	92	52.832226051667746	4	1	5
971	PVWN01	Chlorogloea	168	42.290562175907986	6	6	12
972	CACJBP01	Prochlorococcus	66	31.735465377593616	1	0	1
973	JAAHFN01	Oscillatoria	182	47.066853266869934	4	10	14
974	QCTA01	Prochlorococcus	73	31.148932777492345	2	1	3
975	QCED01	Prochlorococcus	52	31.220552668271157	2	2	4
976	CACKIA01	Prochlorococcus	47	31.551629574101575	3	0	3
977	DNOW01	Cyanobacteria	901	44.17053673176579	15	2	17
978	QCJG01	Prochlorococcus	29	34.59022794393712	1	2	3
979	NJHV01	Cylindrospermopsis	668	40.07492305221896	9	4	13
980	PXCV01	Cyanobacteria	748	52.056044782978546	5	0	5
981	CACBTG01	Prochlorococcus	60	31.962139054565593	1	2	3
982	QCEO01	Prochlorococcus	37	31.40854910671942	0	4	4
983	CACEPF01	Prochlorococcus	54	32.05070825572772	3	1	4
984	QCJL01	Prochlorococcus	19	38.915314542023644	1	0	1
985	UCNV01	Synechococcus	15	57.43297027212858	0	6	6
986	BDUD01	Nostoc	11	41.486711560493916	0	19	19
987	QCTJ01	Synechococcus	82	55.51599015838363	4	3	7
988	QCEY01	Prochlorococcus	34	31.470197862536264	1	1	2
989	CACMZV01	Prochlorococcus	50	31.73581462126021	0	3	3
990	CACEPP01	Prochlorococcus	76	31.803184348561132	2	1	3
991	QCJZ01	Prochlorococcus	67	38.69066836058888	1	0	1
992	DFEL01	Cyanobacteria	188	31.323147804990924	0	0	0
993	CABZFW01	Prochlorococcus	48	32.19628841197581	0	3	3
994	QBLT01	Leptolyngbya	412	57.70232512661078	4	1	5
995	DOWB01	Cyanobacteria	232	35.6693706953217	0	0	0
996	RDZO01	Oscillatoriales	491	45.438657963325944	6	1	7
997	CABXTM01	Synechococcaceae	21	31.53782910036863	0	0	0
998	DHMN01	Cyanobacteria	84	33.938248383624	0	0	0
999	QCTW01	Synechococcus	15	55.67538709414495	0	1	1
1000	QCER01	Prochlorococcus	47	31.515018392080034	0	4	4
1001	QCJQ01	Prochlorococcus	49	34.02503336573967	2	1	3
1002	CACKFT01	Synechococcus	79	59.740914984333564	3	0	3
1003	JNBB01	Prochlorococcus	61	49.91854204045501	13	7	20
1004	LVHV01	Synechococcus	33	54.74898577457853	6	26	32
1005	QBZN01	Prochlorococcus	24	32.69041349102355	1	0	1
1006	QCBF01	Prochlorococcus	54	31.577069258295246	1	3	4
1007	CACCKF01	Prochlorococcus	56	32.15122867857395	1	0	1
1008	QCME01	Prochlorococcus	16	31.983161289277106	0	2	2
1009	QCSC01	Prochlorococcus	80	31.524167747635875	1	4	5
1010	CACMLG01	Prochlorococcus	50	31.449087371739655	0	1	1
1011	CACHZW01	Synechococcus	39	55.55410965614294	1	0	1
1012	QCBM01	Prochlorococcus	21	29.699837952752464	2	2	4
1013	AANO01	Synechococcus	135	55.911894748678485	2	9	11
1014	NDGV01	Cyanobacterium	4027	68.06735857626094	6	10	16
1015	LVHK01	Prochlorococcus	47	48.111367152790024	4	9	13
1016	MWMJ01	Synechococcus	79	51.892258137561484	1	3	4
1017	CACJVV01	Prochlorococcus	55	31.37200476223324	1	0	1
1018	CACIBI01	Prochlorococcus	31	35.48780124402892	1	0	1
1019	CACPKH01	Prochlorococcus	41	35.80205183977866	2	3	5
1020	CACFLN01	Prochlorococcus	61	36.185863267264686	0	2	2
1021	DEGT01	Cyanobacteria	35	34.32359999765165	0	0	0
1022	QCBP01	Prochlorococcus	40	31.09134125454159	3	1	4
1023	CACCKP01	Prochlorococcus	37	31.966767599268806	1	0	1
1024	CACHDL01	Prochlorococcus	43	31.646810842878743	1	2	3
1025	LYXA01	Cylindrospermopsis	6	41.927052782437926	0	8	8
1026	QCSU01	Prochlorococcus	49	32.50522664917018	1	1	2
1027	QCDH01	Prochlorococcus	33	31.991425866084946	2	1	3
1028	QCKK01	Prochlorococcus	37	39.09599392687075	2	2	4
1029	QCUM01	Synechococcus	90	55.79409134122706	2	2	4
1030	DJQF01	Cyanobacteria	69	32.082694639515616	1	0	1
1031	CACOIV01	Prochlorococcus	68	31.05919863374771	3	1	4
1032	JAACTD01	Cyanobacteria	184	32.521858730156204	3	0	3
1033	QBMN01	Leptolyngbya	287	58.65571876143649	2	1	3
1034	CACLRA01	Synechococcaceae	20	31.889146356742128	0	0	0
1035	MRCD01	Calothrix	243	38.537379226939365	14	9	23
1036	CACBDN01	Prochlorococcus	68	31.660175333508338	2	0	2
1037	JAADAK01	Microcystis	668	42.51246725269403	15	0	15
1038	QCUF01	Prochlorococcus	82	31.0271596204829	1	2	3
1039	CABYSR01	Prochlorococcus	75	35.458199977618065	3	0	3
1040	QCUP01	Prochlorococcus	74	31.995135601731523	2	1	3
1041	CACCSS01	Synechococcus	19	52.85392013109184	0	0	0
1042	QCDU01	Prochlorococcus	45	31.76753711637675	0	4	4
1043	CACGCM01	Prochlorococcus	28	31.942976643017975	0	2	2
1044	QBMS01	Snowella	238	40.48471526460677	6	2	8
1045	NGZY01	Fischerella	236	40.489447076240054	10	2	12
1046	CACJNU01	Prochlorococcus	41	32.09783167720557	3	1	4
1047	AVFW01	Planktothrix	289	40.072646503546295	7	3	10
1048	SHBT01	Synechococcus	79	61.91903653517292	2	0	2
1049	MTAV01	Nostoc	270	41.778677323111296	12	5	17
1050	LJOY01	Aphanizomenon	307	38.77071166558658	7	2	9
1051	JAADAV01	Microcystis	615	42.69212614846044	13	3	16
1052	DJYG01	Cyanobacteria	61	30.93161271712375	0	0	0
1053	CACPJY01	Synechococcaceae	40	39.32986969468311	0	4	4
1054	QCRO01	Prochlorococcus	38	41.7164475035295	0	0	0
1055	QCCJ01	Prochlorococcus	37	31.692607886751215	0	1	1
1056	QCLI01	Prochlorococcus	52	36.69873411951431	2	2	4
1057	QCCA01	Prochlorococcus	35	31.720198521234117	0	4	4
1058	JFNW01	Prochlorococcus	330	31.18590832773356	1	3	4
1059	CACMSM01	Prochlorococcus	45	30.620852369213047	1	3	4
1060	QCLB01	Prochlorococcus	46	34.99037844546422	1	3	4
1061	CACNGR01	Prochlorococcus	50	30.842742098507856	1	3	4
1062	LAGZ01	Nostoc	134	41.01544201497055	10	13	23
1063	QCRD01	Prochlorococcus	56	31.110668019134657	1	1	2
1064	PHQT01	Synechococcus	7	60.70448911761836	0	7	7
1065	DJYZ01	Cyanobacteria	202	58.63627986082071	4	1	5
1066	NOXU01	Niveispirillum	32	61.95703707177861	1	5	6
1067	MWLF01	Candidatus	50	59.82880229959434	1	0	1
1068	QCCW01	Prochlorococcus	60	31.78015307588097	2	2	4
1069	JFNA01	Prochlorococcus	278	31.04442938855184	1	3	4
1070	QCLT01	Prochlorococcus	48	31.248789738864346	2	1	3
1071	QCRR01	Prochlorococcus	58	50.52225342397355	2	3	5
1072	QCRY01	Prochlorococcus	82	49.82153781770574	1	2	3
1073	LAHD01	Nostoc	307	43.28325395473265	19	5	24
1074	JFNJ01	Prochlorococcus	317	30.186848562016717	0	3	3
1075	NHBY01	Synechococcus	56	60.536414727287486	3	3	6
1076	CAIK01	Microcystis	433	42.782068076491285	9	2	11
1077	QBTW01	Muricauda	55	46.18198741425631	0	2	2
1078	NQKX01	Synechococcus	18	65.28707348458255	0	8	8
1079	PESY01	Prochlorococcus	9	31.423758253007673	0	4	4
1080	MTBT01	Microcystis	338	42.554107018021156	14	0	14
1081	PVWJ01	Merismopedia	254	41.80293672277377	14	1	15
1082	CACGOG01	Prochlorococcus	72	31.13150955660908	3	0	3
1083	AHGV01	Thermanaerovibrio	2	60.449182674354276	1	0	1
1084	JAAHII01	Leptolyngbya	2	52.09104316294876	0	11	11
1085	JAADBT01	Microcystis	638	42.48186106906263	18	1	19
1086	QCVY01	Prochlorococcus	87	31.18906212402228	2	0	2
1087	SRMM01	Aphanocapsa	125	55.74643559410395	0	2	2
1088	DPOG01	Synechococcus	188	59.14165687095077	3	0	3
1089	CACHNH01	Prochlorococcus	62	31.640676492531647	2	1	3
1090	ALWC01	Synechococcus	8	52.92104623227755	0	8	8
1091	QCHT01	Prochlorococcus	37	37.26906967432622	0	4	4
1092	AGIZ01	Fischerella	34	44.47321260573709	4	7	11
1093	QCVR01	Prochlorococcus	57	41.73979783873952	1	0	1
1094	CACLQU01	Prochlorococcus	68	31.10795350607512	3	0	3
1095	JAAHIB01	Kamptonema	1495	46.660303836447525	5	0	5
1096	PXPK01	Cyanobacteria	254	47.94558906853644	4	2	6
1097	CACIYC01	Prochlorococcus	48	34.881564903722186	1	3	4
1098	RDXJ01	Oscillatoriales	183	45.458570358667004	2	5	7
1099	JAAHFW01	Okeania	197	36.78552022869057	8	7	15
1100	QCGA01	Prochlorococcus	45	38.74792185828751	3	1	4
1101	JAADBI01	Microcystis	779	42.62548163884245	15	0	15
1102	NPIK01	Cylindrospermopsis	188	40.92660498551775	0	7	7
1103	PYGV01	Filamentous	519	57.92489805873186	9	1	10
1104	QCVD01	Synechococcus	81	51.74726685130063	3	4	7
1105	JAADBB01	Microcystis	275	42.291035167568914	11	4	15
1106	QCVO01	Synechococcus	60	52.24435666339616	5	1	6
1107	PTJN01	Gloeocapsopsis	137	42.75535438745237	8	1	9
1108	NHIL01	Cyanobacteria	64	59.45842152402548	0	2	2
1109	QCHI01	Prochlorococcus	41	34.69799541249062	0	3	3
1110	PXPV01	Cyanobacteria	214	47.98859649188256	5	2	7
1111	ALPJ01	Prochlorococcus	232	30.135804593307476	1	0	1
1112	JFMH01	Prochlorococcus	154	32.26284488378206	1	0	1
1113	QBWU01	Prochlorococcus	34	49.84823933349975	1	1	2
1114	QBXV01	Synechococcus	15	51.59404390763192	1	0	1
1115	MWOO01	Prochlorococcus	248	31.899394476371057	2	2	4
1116	DLXW01	Cyanothece	370	36.29596727836527	10	2	12
1117	CACLGR01	Prochlorococcus	69	31.986052473480843	1	0	1
1118	CACLYT01	Synechococcaceae	48	31.010056721956715	0	0	0
1119	QCQP01	Synechococcus	27	54.91503323140313	0	2	2
1120	CACKLP01	Prochlorococcus	71	31.396009781825164	3	0	3
1121	JFMC01	Prochlorococcus	242	31.596160651738785	1	2	3
1122	CABYWR01	Prochlorococcus	94	34.94122176958442	2	0	2
1123	NHAF01	Fischerella	126	40.342632373850776	4	7	11
1124	JFMU01	Prochlorococcus	163	31.504526463158093	0	2	2
1125	QBWH01	Prochlorococcus	62	35.4688128985405	1	1	2
1126	QBXK01	Prochlorococcus	51	30.732233312180917	0	0	0
1127	MWOR01	Prochlorococcus	281	30.968520856651036	0	3	3
1128	CACLYB01	Prochlorococcus	28	31.990764797651657	0	3	3
1129	CACJJC01	Prochlorococcus	45	31.327955244387507	1	1	2
1130	CACATZ01	Synechococcaceae	60	31.697642076845305	0	0	0
1131	QBWC01	Prochlorococcus	67	34.98256618834151	2	2	4
1132	CACOBU01	Prochlorococcus	46	30.370113289430602	1	5	6
1133	MWOY01	Prochlorococcus	212	31.55813039502971	1	2	3
1134	MJGC01	Desertifilum	132	48.43519474369024	5	4	9
1135	QCQM01	Prochlorococcus	68	31.169634700093667	1	2	3
1136	JAAHHE01	Moorea	1017	43.12245756150533	39	6	45
1137	JAAHGF01	Okeania	109	37.01671879213223	5	12	17
1138	QCFP01	Prochlorococcus	38	40.92151412337649	0	1	1
1139	NMQE01	Fischerella	999	41.85487239145071	17	1	18
1140	CACNSF01	Prochlorococcus	47	31.19908988321914	0	2	2
1141	QCIS01	Prochlorococcus	28	31.34874141653138	0	4	4
1142	NHHE02	Synechococcus	47	61.89302243153093	1	7	8
1143	JNAK01	Prochlorococcus	18	31.172311571687253	0	5	5
1144	ALVO01	Geminocystis	11	33.99195592917584	0	5	5
1145	QCIX01	Prochlorococcus	49	31.38449148110702	1	1	2
1146	AJTX02	Prochlorothrix	10	52.708672013690524	0	6	6
1147	JAAHHN01	Spirulina	453	49.39434660958609	7	3	10
1148	JAAHGM01	Okeania	183	37.43569419168217	11	10	21
1149	PXQG01	Cyanobacteria	263	47.958003459308394	4	2	6
1150	NOLJ01	Nostoc	30	41.46969343568768	1	15	16
1151	JAAHHX01	Moorea	1105	42.91495785295982	22	6	28
1152	NYZI01	Cyanobium	146	55.52257765366306	8	0	8
1153	REAX01	Oscillatoriales	656	45.81804684770986	4	0	4
1154	QCFM01	Prochlorococcus	48	36.69495911752409	2	2	4
1155	ALVY01	Gloeocapsa	228	41.169784968086745	11	3	14
1156	JENA01	Candidatus	273	63.214085194881285	2	0	2
1157	MKGP02	Limnothrix	100	54.44656965949788	2	3	5
1158	QCIN01	Prochlorococcus	60	34.97065971743589	0	5	5
1159	CACMYI01	Prochlorococcus	53	31.688783663082706	3	2	5
1160	QCFF01	Prochlorococcus	23	31.64116744976909	1	3	4
1161	JNAV01	Prochlorococcus	9	36.53801423160331	0	4	4
1162	JFKP01	Prochlorococcus	498	31.544678396835476	0	1	1
1163	ALVR01	Spirulina	10	47.18190831966791	0	5	5
1164	QCIE01	Prochlorococcus	27	38.64729957773	2	4	6
1165	DIYQ01	Cyanobacteria	167	44.95344178822462	12	5	17
1166	JAAHHS01	Moorea	834	42.951612289939696	50	8	58
1167	JAAHGP01	Okeania	5155	37.31843123329872	19	1	20
1168	QCPW01	Prochlorococcus	27	30.201840038744166	0	4	4
1169	DNUG01	Synechococcales	139	58.1894931326504	5	4	9
1170	QCAR01	Prochlorococcus	4	33.531094106382696	0	0	0
1171	JFLD01	Prochlorococcus	326	31.05229018853079	1	2	3
1172	QBYZ01	Prochlorococcus	35	31.89221441617679	0	0	0
1173	CACOCO01	Prochlorococcus	49	30.20810583551052	0	2	2
1174	MWPE01	Prochlorococcus	414	31.38976692971347	2	2	4
1175	LUPU01	Prochlorococcus	123	30.967841608607237	4	0	4
1176	CACJKR01	Prochlorococcus	18	32.33553659584463	0	0	0
1177	QBVR01	Prochlorococcus	22	32.65353273939533	1	0	1
1178	QBYQ01	Prochlorococcus	18	35.52043756492563	1	0	1
1179	CACGIB01	Prochlorococcus	37	31.27469170717693	1	0	1
1180	QCNZ01	Prochlorococcus	57	32.060217009207584	2	1	3
1181	JFLO01	Prochlorococcus	170	30.725423884652255	0	4	4
1182	PWXB01	Cyanobacteria	511	55.406772045786894	4	0	4
1183	JFLY01	Prochlorococcus	264	31.997571277687697	1	2	3
1184	QCPJ01	Prochlorococcus	100	48.98496385601886	1	1	2
1185	MBRD01	Nostoc	36	41.23825934675755	2	13	15
1186	JTJD01	Aphanocapsa	296	33.466862676123206	2	5	7
1187	QBVO01	Prochlorococcus	17	30.717716040722127	1	0	1
1188	QCPA01	Prochlorococcus	41	32.33024711318865	2	1	3
1189	RFLH01	Cyanobacteria	878	38.11536030358423	4	0	4
1190	QCNG01	Prochlorococcus	51	31.920037455575486	1	0	1
1191	CACKBB01	Prochlorococcus	20	32.814560598986354	0	0	0
1192	JFLR01	Prochlorococcus	384	31.601459881615337	1	3	4
1193	RDYZ01	Oscillatoriales	496	53.08890449985998	1	1	2
1194	JAAHGQ01	Symploca	1185	42.53798354348511	42	1	43
1195	JAAHHR01	Okeania	1133	36.615886792141175	17	2	19
1196	JNAW01	Prochlorococcus	7	37.55219630502969	0	4	4
1197	ALVS01	Fischerella	95	40.22540996959283	21	11	32
1198	JFKQ01	Prochlorococcus	288	31.186925612938882	2	2	4
1199	QCID01	Prochlorococcus	44	35.15901794746316	2	2	4
1200	QCFG01	Prochlorococcus	33	33.95701463218079	1	0	1
1201	ALVX01	Fischerella	43	40.67725260586522	4	12	16
1202	JFKZ01	Prochlorococcus	183	31.349883196960015	0	2	2
1203	QCIO01	Prochlorococcus	52	31.65689077324729	2	1	3
1204	QCFL01	Prochlorococcus	42	37.045364960118775	0	2	2
1205	REAY01	Oscillatoriales	262	44.61628593945866	3	1	4
1206	CACGPQ01	Synechococcaceae	64	32.14485260738604	1	1	2
1207	JAAHGZ01	Symploca	1347	44.35262970285174	48	0	48
1208	JAAHHY01	Moorea	1521	43.388401426877984	67	1	68
1209	FXBO01	Synechococcus	6	46.126427585318844	0	4	4
1210	NOLK01	Nostoc	397	41.65277281639406	32	6	38
1211	JAAHGL01	Symploca	470	42.58339577017547	24	7	31
1212	PXQF01	Cyanobacteria	222	46.81360447290689	0	0	0
1213	JAAHHO01	Leptolyngbya	1508	45.41370220855304	15	0	15
1214	CACBIT01	Synechococcaceae	51	31.700921746834815	1	0	1
1215	CACGNA01	Prochlorococcus	57	31.42475784617122	1	2	3
1216	JNAJ01	Prochlorococcus	22	30.863127691974523	0	5	5
1217	ALVN01	Leptolyngbya	14	48.2024466361617	0	12	12
1218	QCIY01	Prochlorococcus	30	30.676346991095308	1	3	4
1219	QCFZ01	Prochlorococcus	41	38.96225246150274	1	2	3
1220	REAO01	Oscillatoriales	499	45.34368460127635	8	0	8
1221	PAXG01	Cyanobium	57	55.36344306736572	2	0	2
1222	CACEMU01	Synechococcus	30	55.472360799523244	1	0	1
1223	ALVV02	Leptolyngbya	80	55.35960419402672	1	5	6
1224	NEED01	Unicellular	82	39.40404368582844	4	3	7
1225	CACHQH01	Prochlorococcus	21	31.091263462882527	0	0	0
1226	NMQD01	Fischerella	2176	41.81816398270956	28	0	28
1227	CACNSG01	Prochlorococcus	33	30.402306996511527	0	4	4
1228	QCIR01	Prochlorococcus	69	33.8452533939021	2	1	3
1229	CACKEW01	Prochlorococcus	34	31.574323546425898	0	0	0
1230	QCFQ01	Prochlorococcus	40	32.75555015531912	1	1	2
1231	CACLAV01	Synechococcaceae	12	32.44653246562067	0	0	0
1232	JAAHGG01	Merismopedia	3057	45.466276665302395	21	1	22
1233	JAAHHD01	Moorea	163	43.28205752960875	14	18	32
1234	AUNA01	Synechococcus	5	56.0715398089106	0	1	1
1235	QCNF01	Prochlorococcus	33	31.068514452692543	0	3	3
1236	JFLS01	Prochlorococcus	149	31.589963659435554	1	2	3
1237	QCAE01	Prochlorococcus	25	34.1039624300202	1	1	2
1238	DMPJ01	Planktothrix	572	38.723926082545674	11	0	11
1239	CACNJU01	Prochlorococcus	49	30.660703327246907	1	1	2
1240	QBVN01	Prochlorococcus	52	34.90770180869417	3	1	4
1241	MBRE01	Oscillatoriales	96	40.77383104974742	1	3	4
1242	PKGD01	Arthrospira	928	44.70196364412058	5	0	5
1243	QCPK01	Prochlorococcus	61	37.32359108123065	2	0	2
1244	MVGR01	Microcystis	6	43.938562946651835	2	13	15
1245	CACMOD01	Prochlorococcus	45	31.664201761155468	2	2	4
1246	JFLX01	Prochlorococcus	143	30.523811900984914	0	4	4
1247	QCAN01	Prochlorococcus	27	35.26240745497146	0	1	1
1248	JFLN01	Prochlorococcus	187	32.16284315479977	1	3	4
1249	QBYP01	Prochlorococcus	21	31.762875827460512	0	0	0
1250	QBVS01	Prochlorococcus	43	31.302564849203705	2	1	3
1251	NZXF01	Synechococcus	73	58.26373779901814	1	5	6
1252	LUPT01	Prochlorococcus	113	31.17969446953594	1	0	1
1253	MWPD01	Prochlorococcus	509	31.34178974560248	4	0	4
1254	CACGFK01	Synechococcaceae	65	31.84098991560416	1	1	2
1255	JFLE01	Prochlorococcus	166	33.38494160840081	2	2	4
1256	QCPV01	Prochlorococcus	30	30.141971681109148	0	4	4
1257	PXPW01	Cyanobacteria	213	48.20122107158298	3	2	5
1258	QJUE01	Prochlorococcus	7	34.71811153859726	0	5	5
1259	CACJSF01	Prochlorococcus	19	32.971038557628624	0	2	2
1260	RDXV01	Nostocales	324	36.41283365839294	20	2	22
1261	QCHH01	Prochlorococcus	69	34.45068081610951	1	3	4
1262	QCGK01	Prochlorococcus	38	31.417202830887383	0	4	4
1263	QCVN01	Synechococcus	96	52.81144660120126	5	0	5
1264	JAADBC01	Microcystis	631	42.78840381181935	16	1	17
1265	CACKUH01	Prochlorococcus	33	32.138765451877894	1	0	1
1266	RCBZ01	Okeania	392	36.94384432374159	16	0	16
1267	DNSU01	Cyanobacteria	223	33.39379939010999	1	0	1
1268	QCVE01	Synechococcus	81	55.265742226500926	1	0	1
1269	JAADBH01	Microcystis	363	42.62717078040607	16	2	18
1270	CACKUC01	Prochlorococcus	17	32.46135140952034	0	0	0
1271	MNPM02	Mastigocladus	53	40.72469466091963	10	13	23
1272	CACMXO01	Prochlorococcus	45	31.973816731953896	2	1	3
1273	CACASR01	Prochlorococcus	38	31.471762290213544	2	3	5
1274	LUHJ01	Anabaena	76	42.50479397190477	4	10	14
1275	JAAHFV01	Moorea	687	43.3562521631541	14	4	18
1276	CACAMT01	Synechococcus	31	54.19825359193227	0	0	0
1277	DLPW01	Prochlorococcus	175	52.65815770565769	4	1	5
1278	PXPJ01	Cyanobacteria	273	48.11363891815138	6	1	7
1279	JAAHIC01	Leptolyngbya	1203	52.290830880164705	9	1	10
1280	QCVS01	Prochlorococcus	32	30.85840019993644	1	4	5
1281	CACKUU01	Synechococcaceae	14	32.09603282026184	0	0	0
1282	ALWB01	Pseudanabaena	464	42.81559883647124	4	1	5
1283	DNME01	Cyanobacteria	770	44.81209057285707	17	2	19
1284	QCHU01	Prochlorococcus	45	34.72398345454091	1	2	3
1285	QCVX01	Prochlorococcus	51	31.274434955394554	2	0	2
1286	CACPNN01	Synechococcus	104	52.04798491340488	2	5	7
1287	JAADBU01	Microcystis	617	42.53525549714972	17	1	18
1288	JAAHIH01	Moorea	24	46.65597924298218	5	42	47
1289	PVWK01	Leptolyngbya	167	51.04677281523301	6	8	14
1290	MTBU01	Microcystis	286	43.22636912219404	6	1	7
1291	QCQL01	Prochlorococcus	40	32.13898471290638	0	2	2
1292	CACHXS01	Prochlorococcus	13	31.43002931207294	0	0	0
1293	CABZRB01	Prochlorococcus	53	32.01996230154998	1	0	1
1294	CACGHR01	Prochlorococcus	77	31.579927107655035	2	1	3
1295	MWOX01	Prochlorococcus	379	31.366209748707075	1	3	4
1296	QBWB01	Prochlorococcus	77	35.00543910570761	1	1	2
1297	CACJEA01	Prochlorococcus	59	31.22610682581236	1	3	4
1298	JYFQ01	Candidatus	229	57.92624386871101	2	0	2
1299	JRFE01	Myxosarcina	76	40.13509529742364	6	7	13
1300	QBXJ01	Prochlorococcus	47	31.990035109799482	1	0	1
1301	LSSA01	Nostoc	425	41.76830157685743	18	8	26
1302	MWOS01	Prochlorococcus	236	30.926613562681577	1	2	3
1303	QBWI01	Prochlorococcus	31	35.15711018386815	0	0	0
1304	NZHY01	Prochlorococcus	63	34.84969092287672	1	0	1
1305	NHAG01	Fischerella	131	40.16567838198549	5	6	11
1306	QCOA01	Prochlorococcus	75	31.879800703612226	2	0	2
1307	JFMT01	Prochlorococcus	381	31.73318448515033	0	1	1
1308	QCQG01	Prochlorococcus	70	31.657830094697374	1	1	2
1309	CACHXX01	Synechococcaceae	21	31.644205916490776	0	0	0
1310	ARCP01	Filamentous	52	46.62057660585984	0	6	6
1311	CACNDQ01	Prochlorococcus	63	31.502980102862796	2	1	3
1312	JFMB01	Prochlorococcus	270	30.785162885518407	1	2	3
1313	CACNUB01	Prochlorococcus	61	30.215992693264674	2	2	4
1314	QCQQ01	Prochlorococcus	79	34.53946557172963	1	0	1
1315	JXQG01	Candidatus	117	61.02985038101242	1	2	3
1316	DKMR01	Richelia	301	33.5971422007197	3	0	3
1317	CACGGL01	Prochlorococcus	61	31.845256384785635	2	0	2
1318	QBXW01	Synechococcus	23	44.80043044612206	4	0	4
1319	CACGHD01	Prochlorococcus	56	31.63325555431431	1	2	3
1320	CACATM01	Prochlorococcus	61	32.072692224035386	0	0	0
1321	QBWT01	Prochlorococcus	64	47.71290948831919	3	2	5
1322	NZVB01	Cyanobium	87	50.83008063946222	7	8	15
1323	QCQZ01	Prochlorococcus	89	35.602811900768636	1	0	1
1324	CACMAV01	Prochlorococcus	38	32.02959989569015	1	1	2
1325	JFMI01	Prochlorococcus	136	31.259603954651123	0	2	2
1326	ALPK01	Prochlorococcus	338	30.96394082070765	1	0	1
1327	CACEZU01	Prochlorococcus	22	31.613977149208726	0	1	1
1328	CABYWN01	Prochlorococcus	33	32.418498182502844	0	1	1
1329	QCUZ01	Synechococcus	147	52.82058464147319	4	1	5
1330	LJOX01	Aphanizomenon	193	38.9534740866543	7	5	12
1331	JAADAW01	Microcystis	481	42.95527034895466	13	1	14
1332	PWRG01	Cyanobacteria	484	55.43511186408717	4	0	4
1333	CACMTS01	Prochlorococcus	40	31.59032082648984	0	1	1
1334	CACNQI01	Prochlorococcus	37	31.326525303630273	1	1	2
1335	AJHB01	Microcystis	1944	42.429235772476254	14	0	14
1336	SHBU01	Synechococcus	111	58.8312575503709	4	4	8
1337	MTAW01	Nostoc	241	41.54008215054575	11	12	23
1338	AVFV01	Planktothrix	486	40.28739691539261	13	2	15
1339	DQEB01	Anabaena	81	36.70238052646855	4	5	9
1340	NGZX01	Fischerella	315	39.587412550747985	11	1	12
1341	NGZS01	Fischerella	128	40.84058535261213	6	8	14
1342	CACLCS01	Synechococcaceae	53	31.455756273785784	1	0	1
1343	ANFQ01	Geitlerinema	266	50.402846668221336	5	3	8
1344	DLSU01	Prochlorococcus	181	53.85115097677812	4	1	5
1345	DOVO01	Cyanobacteria	400	41.11221972746687	5	3	8
1346	CACOIJ01	Prochlorococcus	18	31.470002904679006	1	0	1
1347	CACKGR01	Prochlorococcus	19	32.052000444583484	1	1	2
1348	CACNQB01	Prochlorococcus	18	31.206291958125934	0	4	4
1349	QCDT01	Prochlorococcus	22	30.727773694479843	0	1	1
1350	QCUQ01	Prochlorococcus	42	31.12383588908981	1	3	4
1351	LJOS01	Anabaena	279	37.93009843241333	6	3	9
1352	QCKA01	Prochlorococcus	32	39.10992592635918	0	1	1
1353	CACNQT01	Prochlorococcus	49	31.50927046773944	3	0	3
1354	CACKHG01	Synechococcaceae	53	32.09039479084809	1	0	1
1355	QCUG01	Prochlorococcus	63	31.248767130357823	2	2	4
1356	JAADAJ01	Microcystis	849	42.48105675054538	16	0	16
1357	MRCE01	Phormidium	90	39.686301370475675	3	10	13
1358	ACDW01	Prochlorococcus	6	30.732881325232153	0	5	5
1359	CACLCE01	Prochlorococcus	43	31.46297162726482	2	1	3
1360	CACOIW01	Prochlorococcus	63	31.163194241752656	0	3	3
1361	DGBR01	Prochlorococcus	176	59.2404691030709	3	0	3
1362	QBMD01	Cyanobium	116	66.033978209606	7	3	10
1363	QCUL01	Synechococcus	91	48.21713955493606	4	9	13
1364	QCKJ01	Prochlorococcus	32	40.99468789239747	1	5	6
1365	CACMTE01	Prochlorococcus	52	31.77527849396429	2	1	3
1366	QCDI01	Prochlorococcus	24	31.48401062221343	1	3	4
1367	NQKY01	Synechococcus	47	69.28596150220794	0	8	8
1368	CAIJ01	Microcystis	760	42.27522386150714	15	1	16
1369	JFNK01	Prochlorococcus	426	31.753371893831503	4	0	4
1370	RSCN01	Nostoc	139	41.02506611206738	5	10	15
1371	QCRX01	Prochlorococcus	73	39.96625922794189	2	0	2
1372	LAHE01	Nostoc	325	43.12211526770842	19	5	24
1373	QCRS01	Prochlorococcus	69	40.53843913013558	0	1	1
1374	CABYEB01	Prochlorococcus	62	35.47725829680806	2	1	3
1375	CACFMC01	Prochlorococcus	60	47.07303955326834	0	0	0
1376	NSHF01	Nostoc	985	41.56396039333794	27	1	28
1377	QCLU01	Prochlorococcus	23	31.402169361861727	1	3	4
1378	QCCV01	Prochlorococcus	50	31.449494147362564	2	2	4
1379	MWLG01	Candidatus	62	59.45034239490327	2	0	2
1380	NOXT01	Sandarakinorhabdus	130	64.37828358254004	3	1	4
1381	CACAFA01	Synechococcaceae	15	30.730112419447167	0	0	0
1382	PHQU01	Synechococcus	8	60.0720637753611	0	11	11
1383	CACLUB01	Prochlorococcus	59	32.53314895397821	1	0	1
1384	QCRE01	Prochlorococcus	56	30.944015351786653	2	1	3
1385	CACHTY01	Synechococcaceae	16	32.06574649541848	0	0	0
1386	JFNV01	Prochlorococcus	81	30.67571417363275	0	1	1
1387	QCLC01	Prochlorococcus	101	48.439836759846145	6	0	6
1388	CACFSS01	Prochlorococcus	29	31.79325564809974	1	2	3
1389	CACNYU01	Prochlorococcus	63	30.458995839328185	2	2	4
1390	QCLH01	Prochlorococcus	48	35.44250583094112	1	1	2
1391	QCCK01	Prochlorococcus	29	31.801167543469973	0	3	3
1392	QCJP01	Prochlorococcus	10	35.83805543196644	1	0	1
1393	JNBC01	Prochlorococcus	61	50.26057550959983	11	8	19
1394	CACKIV01	Synechococcaceae	49	31.173408110606758	2	0	2
1395	QCES01	Prochlorococcus	31	31.814251814195217	2	0	2
1396	BBWW01	Leptolyngbya	5	47.38612125581623	0	11	11
1397	CACEPZ01	Synechococcaceae	16	31.084284067221056	1	0	1
1398	QCTV01	Synechococcus	82	56.09625661626976	1	1	2
1399	CACMKY01	Prochlorococcus	68	31.65804466171308	0	1	1
1400	UCNJ01	Synechococcus	35	53.613929897083054	6	24	30
1401	QLZQ01	Planococcus	16	49.187365908150156	0	3	3
1402	CACLBT01	Synechococcaceae	39	31.511886332414452	1	0	1
1403	CACAQA01	Synechococcaceae	38	31.478362554941477	1	1	2
1404	CACBTP01	Prochlorococcus	31	32.05568956092051	1	1	2
1405	CABZFV01	Prochlorococcus	34	31.462203043583955	0	4	4
1406	CACPLK01	Prochlorococcus	69	34.65246876438233	2	0	2
1407	QCEX01	Prochlorococcus	32	34.36658559177444	1	2	3
1408	QCTK01	Prochlorococcus	45	32.807858781754874	0	0	0
1409	UCNW01	Synechococcus	15	56.22037333832288	0	6	6
1410	QCJM01	Prochlorococcus	47	40.165060726094865	0	3	3
1411	PAEU01	Cyanobium	70	60.833390600167334	0	0	0
1412	QCEN01	Prochlorococcus	30	31.504981067460083	1	2	3
1413	NGJL01	Mastigocladus	264	38.86389738967066	9	2	11
1414	NJHW01	Cylindrospermopsis	518	40.750695720883044	7	4	11
1415	DOIX01	Cyanobacteria	437	40.77933116759455	4	4	8
1416	DNOV01	Cyanobacteria	804	44.44064777857842	16	2	18
1417	QCEE01	Prochlorococcus	38	31.226324056162326	2	2	4
1418	PYER01	Filamentous	548	56.85751516341144	7	0	7
1419	CABYLR01	Prochlorococcus	32	31.462379791320892	1	3	4
1420	CACBSY01	Prochlorococcus	55	31.870945031166777	1	2	3
1421	QCST01	Prochlorococcus	53	31.142846593273937	2	0	2
1422	LICO01	Cyanobacterium	570	63.4563942558405	10	0	10
1423	CACNWG01	Prochlorococcus	41	31.366799998948924	1	3	4
1424	QCBQ01	Prochlorococcus	70	32.31980043134424	3	1	4
1425	DPEI01	Cyanobacteria	764	40.90698325762501	13	0	13
1426	DNGJ01	Cyanobacteria	573	44.771912875007864	11	4	15
1427	QCBZ01	Prochlorococcus	43	31.35724264555237	1	3	4
1428	CABYKM01	Prochlorococcus	53	31.27499315279542	1	2	3
1429	QBZR01	Prochlorococcus	46	31.956478545516017	0	1	1
1430	CACOQT01	Prochlorococcus	49	34.16487449582006	4	0	4
1431	QCBL01	Prochlorococcus	34	30.77121347668823	1	2	3
1432	QCSI01	Synechococcus	116	58.18858756819317	4	0	4
1433	FITM01	Candidatus	179	61.70837195733858	3	0	3
1434	QCSB01	Prochlorococcus	60	31.560117469381495	1	0	1
1435	QCMD01	Prochlorococcus	45	31.13747969205883	0	3	3
1436	CACFRT01	Prochlorococcus	44	31.753532410050926	0	0	0
1437	QCBG01	Prochlorococcus	42	30.717105269308387	1	1	2
1438	QBZO01	Prochlorococcus	51	30.840206040039874	1	1	2
1439	PKDM01	Cyanobacterium	1065	35.240615924797396	15	0	15
1440	CACBBJ01	Prochlorococcus	20	31.55339380320882	1	1	2
1441	QCRL01	Prochlorococcus	69	31.610481846590282	1	0	1
1442	AAOK01	Synechococcus	13	53.37144901899088	0	8	8
1443	LAYT01	Arthrospira	359	45.289615091081856	1	1	2
1444	CACKOL01	Prochlorococcus	28	31.343197772218396	0	0	0
1445	QCCI01	Prochlorococcus	42	32.31075249985257	3	0	3
1446	JFNT01	Prochlorococcus	245	30.463240907047933	0	2	2
1447	QCLA01	Prochlorococcus	51	31.054312731344755	1	3	4
1448	QCCB01	Prochlorococcus	34	31.029815768886497	3	0	3
1449	QCRG01	Prochlorococcus	42	30.73994178897874	1	3	4
1450	LAGY01	Nostoc	178	41.604660767192776	8	14	22
1451	DLEF01	Cyanobacteria	77	36.42588291861579	0	0	0
1452	CACAXS01	Prochlorococcus	58	31.484181329446113	3	0	3
1453	CACJWO01	Prochlorococcus	34	31.41715816262716	1	2	3
1454	CABXCX01	Prochlorococcus	7	31.457032004618885	0	1	1
1455	NOXV01	Flavobacterium	306	39.67010446645305	3	0	3
1456	MWLE01	Candidatus	107	60.07445047438921	2	0	2
1457	CACGDL01	Prochlorococcus	71	31.44626978555785	1	0	1
1458	JFNB01	Prochlorococcus	498	31.710517653278924	0	2	2
1459	QCLW01	Prochlorococcus	54	31.626961791774832	3	0	3
1460	QCCT01	Prochlorococcus	45	31.991007929975265	1	3	4
1461	QCRQ01	Prochlorococcus	49	41.788825943943664	1	0	1
1462	LAHG01	Nostoc	345	41.609680324766686	20	5	25
1463	JFNI01	Prochlorococcus	97	31.11098230385508	2	2	4
1464	RSCL01	Calothrix	110	38.8687537359635	10	21	31
1465	CACAXN01	Prochlorococcus	41	31.753682991133946	1	2	3
1466	PXEF01	Cyanobacteria	525	55.66733924530316	1	0	1
1467	CAIH01	Microcystis	438	41.80540184199224	15	1	16
1468	CACBCR01	Prochlorococcus	53	32.11321527469212	2	0	2
1469	QCKH01	Prochlorococcus	27	34.391716870159634	0	2	2
1470	QCDK01	Prochlorococcus	61	31.609936659959565	2	1	3
1471	QCUN01	Synechococcus	80	55.294566372058014	4	3	7
1472	NHJU02	Prochlorococcus	82	52.86797692458725	3	2	5
1473	JAADAC01	Microcystis	687	42.75804904700449	16	0	16
1474	CABXUT01	Prochlorococcus	63	31.263259319043907	2	1	3
1475	CACJAC01	Prochlorococcus	57	31.867965162109623	0	3	3
1476	NRIU01	Geitlerinema	2805	47.90469363929412	6	2	8
1477	MRCG01	Phormidium	44	55.17870744559676	2	6	8
1478	CACANT01	Prochlorococcus	49	31.657190457935542	1	0	1
1479	QBMM01	Cyanobium	95	66.76155547964352	5	3	8
1480	JAADAH01	Microcystis	735	42.54969337231275	14	0	14
1481	QCKC01	Prochlorococcus	38	38.58351418150357	2	1	3
1482	CACKHE01	Prochlorococcus	55	32.12228745746152	0	2	2
1483	CACEQI01	Prochlorococcus	50	30.964585294394784	0	4	4
1484	QCUS01	Prochlorococcus	58	30.851747745305666	2	0	2
1485	LJOQ01	Anabaena	109	38.21946874525581	11	4	15
1486	CACHSO01	Prochlorococcus	36	31.483894605155836	0	1	1
1487	AGJC02	Crocosphaera	7	37.28894510473797	0	7	7
1488	QCDV01	Prochlorococcus	28	31.34525811700794	0	2	2
1489	CACOFK01	Prochlorococcus	67	30.700558658816508	3	2	5
1490	DOVM01	Synechococcales	213	55.43112642641322	4	0	4
1491	CACGCN01	Prochlorococcus	75	31.874722990724106	2	1	3
1492	CACLRT01	Prochlorococcus	40	31.441996060956875	0	0	0
1493	AVFT01	Planktothrix	227	39.841288123014856	10	1	11
1494	QBMP01	Phormidesmis	439	50.44528213325932	7	0	7
1495	NGZZ01	Fischerella	263	38.23918821852298	9	5	14
1496	CACGCE01	Prochlorococcus	35	31.95572935631918	0	0	0
1497	QHKA01	Nostoc	714	63.86239684213018	10	3	13
1498	RFFR01	Cyanobacteria	186	53.78581807265559	2	1	3
1499	QCUX01	Prochlorococcus	68	30.829018970542492	3	1	4
1500	LWHC01	Cyanobacterium	136	36.51235869425449	2	2	4
1501	JAADAU01	Microcystis	353	42.80740036239866	14	1	15
1502	PBPY01	Synechococcus	96	62.360071754923915	1	1	2
1503	CACBBH01	Prochlorococcus	44	31.522880223076967	1	0	1
1504	QBZM01	Prochlorococcus	36	32.21870109818835	1	0	1
1505	LVHU01	Synechococcus	23	55.35474581415843	2	9	11
1506	CACMRI01	Prochlorococcus	39	31.828629805349784	0	2	2
1507	QCMF01	Prochlorococcus	48	32.92374255827803	1	0	1
1508	BBPA01	Microcystis	79	43.70113692306471	3	7	10
1509	QCBE01	Prochlorococcus	48	31.38871097155591	2	1	3
1510	CACMLO01	Prochlorococcus	47	31.526416149080443	2	1	3
1511	QCSK01	Synechococcus	144	58.658094366681176	3	0	3
1512	CACKAH01	Prochlorococcus	77	31.300448508149756	0	3	3
1513	QCMM01	Synechococcus	69	58.50270501755498	0	2	2
1514	QCBN01	Prochlorococcus	34	32.5670638677046	2	1	3
1515	QBZF01	Prochlorococcus	53	31.78942833599285	0	0	0
1516	QBZP01	Prochlorococcus	32	31.84242517996997	0	0	0
1517	LXQD01	Nostoc	359	41.47146527882852	17	16	33
1518	CABXSG01	Prochlorococcus	14	32.93566617511574	1	0	1
1519	QCBX01	Prochlorococcus	26	31.51254220468976	0	4	4
1520	JFOE01	Prochlorococcus	346	31.3973524824334	1	1	2
1521	QCBS01	Prochlorococcus	32	31.443288943990876	2	1	3
1522	CABZPX01	Prochlorococcus	42	31.567033708705328	2	0	2
1523	QCSV01	Prochlorococcus	75	31.53238284005864	2	1	3
1524	MBQX01	Cylindrospermopsis	162	40.15658275701546	4	4	8
1525	DGDH01	Richelia	418	37.08303600674542	19	1	20
1526	CACLET01	Prochlorococcus	70	31.441119762212214	1	0	1
1527	LUBZ01	Cylindrospermopsis	195	40.86899597654933	4	6	10
1528	QCTB01	Prochlorococcus	66	30.991889691443628	0	0	0
1529	BIFY01	Microcystis	444	41.26534964369984	16	3	19
1530	CACMDN01	Synechococcus	37	55.36453738483007	1	1	2
1531	QCEG01	Prochlorococcus	49	32.00135824297984	0	3	3
1532	NHKA01	Cyanobacteria	30	57.89056947156885	0	2	2
1533	NJHU01	Cylindrospermopsis	432	40.26310807918758	4	6	10
1534	DOFR01	Synechococcus	230	61.831761333402845	2	0	2
1535	CACBJB01	Prochlorococcus	41	31.905306481845205	2	1	3
1536	JAACDE01	Synechococcales	271	55.01180659171706	4	0	4
1537	CACGBT01	Prochlorococcus	53	31.03980056484455	0	4	4
1538	QCJO01	Prochlorococcus	46	37.08829687376772	1	3	4
1539	AWNH01	Leptolyngbya	119	47.93030604186449	7	6	13
1540	QCEL01	Prochlorococcus	27	31.26903197659574	1	1	2
1541	QCTI01	Synechococcus	71	55.310713924975495	5	5	10
1542	UCNU01	Synechococcus	18	57.77787500845155	0	5	5
1543	QCJY01	Prochlorococcus	29	39.399999617621745	0	2	2
1544	CACNPL01	Prochlorococcus	51	31.922674441961455	1	2	3
1545	CACMUV01	Synechococcus	45	56.87531116097405	3	0	3
1546	QCEZ01	Prochlorococcus	51	39.24347913384436	2	1	3
1547	CABYRK01	Prochlorococcus	39	30.95330436668043	3	1	4
1548	CACHRC01	Prochlorococcus	46	32.33635535110613	2	2	4
1549	CACNAI01	Prochlorococcus	51	31.126385212437366	0	2	2
1550	CAQK01	Crocosphaera	869	37.73694320763543	21	0	21
1551	LSYZ01	Leptolyngbya	420	59.95363324540462	6	0	6
1552	LMTZ01	Mastigocoleus	172	37.28870091151714	12	11	23
1553	CACBTY01	Prochlorococcus	9	32.24862270674559	0	1	1
1554	CACOHO01	Prochlorococcus	71	30.28941624343569	3	0	3
1555	CACJOZ01	Prochlorococcus	49	31.8984916018012	1	1	2
1556	CACOYJ01	Prochlorococcus	57	31.269659673661973	1	3	4
1557	LFEK01	Synechococcus	125	68.11158768589814	3	7	10
1558	QCTT01	Synechococcus	48	56.37017320206016	1	0	1
1559	QCJR01	Prochlorococcus	20	34.50263862650819	0	1	1
1560	JNBA01	Prochlorococcus	53	50.00015741519578	10	9	19
1561	QCEQ01	Prochlorococcus	45	30.70306938337601	1	3	4
1562	MKZR01	Moorea	79	48.6439261586057	3	31	34
1563	CACHYK01	Prochlorococcus	20	31.41665163943977	0	0	0
1564	CACHGM01	Synechococcus	9	46.36841484226926	0	1	1
1565	CACKBW01	Prochlorococcus	29	31.22883917924397	0	0	0
1566	JFLG01	Prochlorococcus	144	31.974722066631468	0	3	3
1567	QCAQ01	Prochlorococcus	20	34.99221395715168	2	0	2
1568	CACKMT01	Prochlorococcus	35	32.949738374420406	1	2	3
1569	QBYY01	Prochlorococcus	34	31.184798168875236	1	0	1
1570	QBVZ01	Prochlorococcus	59	34.56885299805983	1	1	2
1571	MWPF01	Prochlorococcus	268	31.278013209461374	3	0	3
1572	AXUW01	Synechococcus	9	54.89931202052806	0	1	1
1573	CACBAW01	Synechococcaceae	65	31.156151876026907	2	1	3
1574	CACINK01	Prochlorococcus	34	31.30623353192944	1	2	3
1575	LUPV01	Prochlorococcus	101	31.501207323860115	3	0	3
1576	QBYR01	Prochlorococcus	7	32.902891262511716	0	0	0
1577	QBVQ01	Prochlorococcus	20	32.187459872524485	0	1	1
1578	QCNY01	Prochlorococcus	61	32.0722511670712	1	0	1
1579	JFLL01	Prochlorococcus	295	30.637375541851934	0	4	4
1580	CACCGY01	Prochlorococcus	33	31.548752378736737	1	0	1
1581	JFLZ01	Prochlorococcus	368	31.190706011516294	1	0	1
1582	QCAL01	Prochlorococcus	33	34.71175683563741	2	0	2
1583	MNYZ01	Oscillatoriales	119	40.129914224515694	2	2	4
1584	QCPI01	Prochlorococcus	45	34.73072783903014	0	4	4
1585	LZQD01	Trichormus	58	40.326936597260016	1	9	10
1586	CACHVU01	Prochlorococcus	60	31.3983704741353	0	0	0
1587	DOMQ01	Synechococcales	206	52.390790281833326	5	1	6
1588	QBYO01	Prochlorococcus	31	34.98832617252459	0	1	1
1589	QBVL01	Prochlorococcus	55	35.170503553010874	1	2	3
1590	CACJZI01	Prochlorococcus	46	31.98878591812565	1	0	1
1591	BDQL01	Aphanothece	95	38.120434593734515	6	5	11
1592	QCPB01	Prochlorococcus	40	31.690639791357434	3	0	3
1593	QCND01	Prochlorococcus	89	35.27154123376246	4	0	4
1594	JFLQ01	Prochlorococcus	180	30.98741140334165	2	2	4
1595	QCAG01	Prochlorococcus	42	35.40573052798538	3	0	3
1596	JAAHGE01	Desertifilum	1045	47.975617207754645	13	1	14
1597	JAAHHF01	Okeania	2566	37.483974564003724	14	1	15
1598	CACGNH01	Prochlorococcus	45	32.42527849102471	1	0	1
1599	RDYN01	Oscillatoriales	218	45.708470011609606	3	1	4
1600	NMQF01	Fischerella	922	41.030911249287996	14	0	14
1601	LWTK01	Nostoc	113	41.766323348824315	6	19	25
1602	QCIP01	Prochlorococcus	26	30.938892713771093	0	4	4
1603	REAF01	Oscillatoriales	692	45.40842424232387	9	0	9
1604	CACHQJ01	Synechococcus	14	52.80257689908309	0	1	1
1605	JFKN01	Prochlorococcus	378	30.59067341212376	1	1	2
1606	ALVL01	Pleurocapsa	30	38.82856462027615	1	21	22
1607	JNAH01	Prochlorococcus	11	32.048825107194006	0	4	4
1608	QCFX01	Prochlorococcus	40	39.66973231869566	3	3	6
1609	PXQD01	Cyanobacteria	252	48.071070715807394	6	0	6
1610	JAAHGN01	Moorea	1594	43.719229533512284	41	2	43
1611	JAAHHM01	Moorea	386	43.82446535159535	21	10	31
1612	RDYS01	Oscillatoriales	668	44.50768623959374	3	0	3
1613	NOLI01	Nostoc	378	41.428189727923744	36	5	41
1614	JAAHGX01	Okeania	589	41.77798320226125	18	6	24
1615	PYFY01	Filamentous	730	57.14953925052384	9	0	9
1616	JFKX01	Prochlorococcus	159	31.572828777779872	1	2	3
1617	ALVZ01	Xenococcus	234	39.70736148037871	9	5	14
1618	CVSW01	Prochlorococcus	120	30.546910317458135	0	3	3
1619	QCIM01	Prochlorococcus	56	34.5872783820284	0	2	2
1620	QCFN01	Prochlorococcus	55	38.956102527750254	2	2	4
1621	JFKS01	Prochlorococcus	187	31.104758717407634	0	0	0
1622	ALVQ01	Spirulina	13	50.74764029515719	0	6	6
1623	JNAU01	Prochlorococcus	6	37.53369444923084	0	5	5
1624	QCIF01	Prochlorococcus	34	31.012576113950704	0	4	4
1625	REAP01	Oscillatoriales	282	44.66587051614676	1	3	4
1626	QCFE01	Prochlorococcus	47	36.86997332777329	2	2	4
1627	DNRP01	Cyanobacteria	188	33.70960914581963	0	0	0
1628	CABZJH01	Prochlorococcus	50	31.757429401897472	3	1	4
1629	DBYM01	Cyanobacteria	78	38.49793201440403	2	0	2
1630	CACBFH01	Prochlorococcus	50	31.12059767218509	1	2	3
1631	JAAHGS01	Symploca	383	43.49788161985074	13	6	19
1632	JAAHHP01	Moorea	398	43.74280674189884	25	11	36
1633	ALPI01	Prochlorococcus	158	31.578447620540345	0	0	0
1634	JFMK01	Prochlorococcus	159	32.2256591719116	0	2	2
1635	AZXL01	Synechococcus	17	54.6777104455129	0	6	6
1636	QCQX01	Prochlorococcus	49	30.579406517518372	3	3	6
1637	QQWE01	Microcystis	20	43.096174480544775	0	12	12
1638	DORF01	Cyanobacteria	500	40.57908545000018	7	0	7
1639	CACGHM01	Synechococcaceae	44	32.06353587641914	0	0	0
1640	DBAX01	Cyanobacteria	145	56.573763204412884	0	1	1
1641	QCQS01	Prochlorococcus	77	31.943795188708837	2	0	2
1642	JAAGOG01	Nostoc	515	41.60185791597876	21	2	23
1643	QCOU01	Prochlorococcus	70	39.094788415830244	1	0	1
1644	LJZT01	Phormidium	187	51.041194637378446	2	3	5
1645	ALPB01	Prochlorococcus	108	31.035543000345047	0	0	0
1646	AJLK01	Fischerella	271	41.34488456840159	10	7	17
1647	QCOC01	Prochlorococcus	14	33.41888298731238	0	0	0
1648	NHAE01	Fischerella	199	40.53627554311398	9	3	12
1649	JFMV01	Prochlorococcus	126	30.865196562264934	1	3	4
1650	QBXH01	Prochlorococcus	48	30.494793656117906	3	2	5
1651	MWOQ01	Prochlorococcus	330	31.03993118272913	1	1	2
1652	QBWK01	Prochlorococcus	42	34.68368156256114	2	2	4
1653	MWOZ01	Prochlorococcus	558	31.000695936855784	3	0	3
1654	CABYWZ01	Prochlorococcus	46	31.018011640933167	2	1	3
1655	QCQN01	Prochlorococcus	46	31.046441992149283	1	3	4
1656	CACCWM01	Synechococcus	54	56.75331753762725	1	2	3
1657	PVWI01	Filamentous	526	45.42441005114442	4	0	4
1658	RDXB01	Oscillatoriales	111	56.45694515927779	1	2	3
1659	QCVZ01	Prochlorococcus	66	31.953462221687115	2	0	2
1660	DFVO01	Candidatus	13	30.62699876858538	0	3	3
1661	SRMN01	Aphanocapsa	214	63.326081635589674	2	0	2
1662	CACHAH01	Prochlorococcus	51	31.636309949292016	1	0	1
1663	QCHW01	Prochlorococcus	42	31.436872684996604	0	1	1
1664	AQPY01	Microcystis	1363	41.8508289617402	21	0	21
1665	QCGT01	Prochlorococcus	49	35.29877116747205	2	3	5
1666	QCVQ01	Synechococcus	64	52.6077329433964	1	4	5
1667	JAAHIA01	Leptolyngbya	848	53.62688380964064	5	1	6
1668	JAAHFT01	Cyanothece	1397	46.959087771974936	18	1	19
1669	CACIGP01	Prochlorococcus	69	35.5709738178969	0	0	0
1670	CACBYI01	Prochlorococcus	37	31.574500806783867	1	2	3
1671	MQTZ01	Leptolyngbya	77	51.51536730224046	1	3	4
1672	CACKKG01	Prochlorococcus	43	31.895268416467626	1	1	2
1673	QCGB01	Prochlorococcus	19	40.23736857519473	0	0	0
1674	QCVG01	Prochlorococcus	41	31.367884683177692	1	1	2
1675	JAADBJ01	Microcystis	801	42.464847815171126	20	0	20
1676	AOCI01	Microcystis	335	41.50306745350901	11	1	12
1677	QCVL01	Synechococcus	19	53.82655546512613	1	0	1
1678	JAADBA01	Microcystis	392	42.62671692623575	13	4	17
1679	CACPNZ01	Synechococcus	24	55.32495450943144	3	0	3
1680	QCHJ01	Prochlorococcus	39	34.56780798911624	3	1	4
1681	PXPU01	Cyanobacteria	239	48.102591607562864	3	2	5
1682	QCQO01	Synechococcus	24	53.71036221272177	2	0	2
1683	QBWA01	Prochlorococcus	61	35.04852310267565	1	1	2
1684	QBWJ01	Prochlorococcus	24	35.247967486017934	1	0	1
1685	CACGGY01	Prochlorococcus	79	31.871436914436455	1	0	1
1686	QBXI01	Prochlorococcus	53	30.365352535469626	1	2	3
1687	JAACPM01	Cyanobacteria	213	32.57379511472839	2	1	3
1688	MWOP01	Prochlorococcus	572	30.995989664737603	2	1	3
1689	DEEN01	Cyanobacteria	21	35.246569370690715	0	0	0
1690	QCOB01	Prochlorococcus	55	34.914173654622054	1	0	1
1691	NHAD01	Fischerella	101	40.10042959432622	3	8	11
1692	JFMW01	Prochlorococcus	445	30.95132619277826	0	2	2
1693	AJLJ01	Fischerella	524	40.47890148237308	16	7	23
1694	LWRO01	Geitlerinema	113	49.649871975610175	2	8	10
1695	QCOT01	Prochlorococcus	55	35.09327207379298	1	1	2
1696	JFMA01	Prochlorococcus	519	30.934707646006537	2	1	3
1697	ALPC01	Prochlorococcus	197	31.724585301241216	0	0	0
1698	CABZCY01	Synechococcaceae	60	30.864738881373853	1	1	2
1699	QCQR01	Prochlorococcus	59	32.176041854953844	1	0	1
1700	BEYQ01	Microcystis	97	40.68649878278268	3	10	13
1701	CACLGP01	Synechococcaceae	51	30.214366784742232	0	1	1
1702	QBWW01	Prochlorococcus	34	46.81262997360825	1	1	2
1703	DORG01	Cyanobacteria	741	39.668482196310265	10	0	10
1704	QBXT01	Synechococcus	10	52.15559316841283	2	0	2
1705	NBYN01	Cylindrospermopsis	77	43.02054633735386	6	3	9
1706	QQWD01	Microcystis	68	43.010315354938776	2	5	7
1707	QCQY01	Prochlorococcus	56	31.648746527767507	0	2	2
1708	CACFAJ01	Prochlorococcus	46	31.61859056020026	1	3	4
1709	CACPFL01	Prochlorococcus	60	31.824799024950813	2	1	3
1710	JFMJ01	Prochlorococcus	266	31.984773016916954	1	2	3
1711	ALPH01	Prochlorococcus	349	31.089511698270286	1	0	1
1712	PXPT01	Cyanobacteria	196	47.995096612482975	2	4	6
1713	MDVL01	Euhalothece	1408	50.0225559357269	7	0	7
1714	RDXU01	Oscillatoriales	637	45.36246686043261	6	1	7
1715	QJUF01	Prochlorococcus	8	35.126671041434044	0	4	4
1716	QCHK01	Prochlorococcus	62	35.52784944057071	0	3	3
1717	AJUS01	Microcystis	2045	42.22280029390111	5	0	5
1718	JXYX01	Microcystis	29	40.749746371018496	1	8	9
1719	QCVM01	Synechococcus	102	51.76312355473134	2	0	2
1720	JAADBK01	Microcystis	594	42.49596503970298	20	0	20
1721	RCBY01	Okeania	716	38.09282927136351	15	1	16
1722	QCVF01	Synechococcus	54	56.36949813956094	1	1	2
1723	CABYAW01	Synechococcaceae	14	31.389023981097534	1	0	1
1724	QCGC01	Prochlorococcus	32	39.58587672879399	0	2	2
1725	CABYPR01	Prochlorococcus	38	34.886634759831715	1	0	1
1726	LUHI01	Anabaena	91	41.09876093504464	3	9	12
1727	JAAHFU01	Leptolyngbya	658	52.29114719669604	9	14	23
1728	DBIX01	Cyanobacteria	84	31.375318942194028	0	2	2
1729	RDXH01	Oscillatoriales	408	44.46003250733117	4	0	4
1730	PXPI01	Cyanobacteria	136	44.13788107092527	2	0	2
1731	CACNCF01	Prochlorococcus	38	31.965655146787725	1	3	4
1732	QCVP01	Synechococcus	55	52.07870708199982	3	3	6
1733	CACFWF01	Prochlorococcus	34	35.869018373544655	0	1	1
1734	CACVCJ01	Prochlorococcus	33	30.592011299138022	1	2	3
1735	ALWA01	Cyanobacterium	42	42.26497215322255	2	9	11
1736	QCHV01	Prochlorococcus	44	37.66980089097458	2	3	5
1737	SRMO01	Aphanocapsa	100	57.14759435782712	0	2	2
1738	CABYPO01	Prochlorococcus	58	35.11539438063342	0	0	0
1739	JAADBV01	Microcystis	589	42.73380150531898	16	1	17
1740	CABXYB01	Prochlorococcus	33	30.65306807259375	0	0	0
1741	CACBHP01	Prochlorococcus	48	31.66994453183956	0	2	2
1742	PVWH01	Filamentous	905	45.36389975896369	2	0	2
1743	CACIVI01	Prochlorococcus	29	35.23692986809562	0	2	2
1744	RDXC01	Oscillatoriales	690	44.394041641969636	5	0	5
1745	QCAF01	Prochlorococcus	18	34.39554365502417	2	0	2
1746	QCNE01	Prochlorococcus	41	31.90654276173227	0	3	3
1747	JFLP01	Prochlorococcus	205	31.104194326057378	2	2	4
1748	QCPC01	Prochlorococcus	38	35.33648939268337	1	2	3
1749	QBVM01	Prochlorococcus	19	35.10877051628285	1	0	1
1750	CACLWO01	Synechococcaceae	10	28.77354744704227	0	0	0
1751	MBRF01	Limnothrix	33	54.917802883883425	0	3	3
1752	QCPH01	Prochlorococcus	73	47.84120684047166	3	0	3
1753	JFLM01	Prochlorococcus	300	31.654011217587747	0	3	3
1754	CACMQW01	Prochlorococcus	35	31.498343801010606	2	0	2
1755	QBVP01	Prochlorococcus	21	36.351016697246315	0	0	0
1756	QBYS01	Prochlorococcus	59	34.85593987343487	2	1	3
1757	CACJDX01	Synechococcus	22	56.26357260769853	3	0	3
1758	JTJC02	Scytonema	250	39.917431383396085	26	5	31
1759	AXUV01	Synechococcus	6	52.27829036452178	0	1	1
1760	CACLXQ01	Prochlorococcus	66	31.202793070505038	0	0	0
1761	MWPG01	Prochlorococcus	190	31.28037228359069	1	0	1
1762	CACGIK01	Prochlorococcus	73	31.616358228694594	1	1	2
1763	CACHGL01	Synechococcaceae	18	32.21648192142802	0	0	0
1764	JFLF01	Prochlorococcus	337	31.318784425629325	0	3	3
1765	CACKSS01	Prochlorococcus	38	35.41501409288243	0	0	0
1766	QCPU01	Prochlorococcus	30	31.249388995145573	2	2	4
1767	CACARV01	Prochlorococcus	69	31.342694910273867	0	1	1
1768	JAAHHQ01	Moorea	2143	43.72013832780353	65	1	66
1769	JAAHGR01	Symploca	1437	43.32712458477367	35	2	37
1770	QCFD01	Prochlorococcus	37	34.6610075272422	2	2	4
1771	CACKJA01	Prochlorococcus	25	32.602780355281105	0	0	0
1772	ALVP01	Nodosilinea	62	56.33182255597005	1	5	6
1773	JFKR01	Prochlorococcus	523	31.089871637951887	0	3	3
1774	JNAT01	Prochlorococcus	14	35.44139462691463	0	4	4
1775	QCIG01	Prochlorococcus	64	34.62125209478465	2	2	4
1776	JMKF01	[Leptolyngbya]	122	50.37376007575846	9	4	13
1777	QCFO01	Prochlorococcus	42	39.51056037167598	1	5	6
1778	JFKY01	Prochlorococcus	299	31.525445902444254	1	2	3
1779	CVSV01	Prochlorococcus	136	31.25452849721637	0	2	2
1780	QCIL01	Prochlorococcus	44	31.049683485027025	1	2	3
1781	MVOP01	Prochlorococcus	376	31.027778686265947	1	1	2
1782	LAMW01	Trichodesmium	201	35.33151677601305	4	0	4
1783	DBVD01	Prochlorococcus	210	53.437852487449284	8	0	8
1784	JAAHHZ01	Moorea	604	43.29343017377111	19	8	27
1785	JAAHGY01	Cyanothece	1148	48.82932912050814	27	0	27
1786	CACLAH01	Synechococcaceae	16	29.33787047345117	0	0	0
1787	RDYR01	Oscillatoriales	209	45.92899358806418	1	2	3
1788	SEBC01	Cyanobacteria	41	32.8858532708634	0	0	0
1789	JAAHHL01	Symploca	1883	43.20584022975567	27	1	28
1790	PXQE01	Cyanobacteria	218	48.08779497495799	5	0	5
1791	JAAHGO01	Okeania	317	38.39797894478558	12	14	26
1792	QCFY01	Prochlorococcus	38	39.635047469881776	1	2	3
1793	ALVM01	Leptolyngbya	19	46.391529644895066	0	14	14
1794	JFKO01	Prochlorococcus	235	31.996527771719343	1	0	1
1795	JNAI01	Prochlorococcus	13	32.7463555441236	0	5	5
1796	QCIZ01	Prochlorococcus	43	34.560774327802214	3	3	6
1797	ALVU02	Synechocystis	8	43.02050603897168	0	7	7
1798	DCNZ01	Cyanobacteria	272	44.774342055301936	14	6	20
1799	QCFR01	Prochlorococcus	34	37.20334602550857	3	0	3
1800	NMQG01	Fischerella	364	40.557786737409415	15	0	15
1801	DNLA01	Pseudanabaena	317	39.77642759928027	3	1	4
1802	QCIQ01	Prochlorococcus	57	34.57824445303559	1	2	3
1803	CACGAJ01	Synechococcaceae	68	31.441129145488638	1	1	2
1804	PXOH01	Aphanothece	120	39.2493947787163	2	6	8
1805	NYUU01	Synechococcus	147	55.43969623380849	5	1	6
1806	JAAHHG01	Okeania	789	36.89070245968246	28	2	30
1807	JAAHGD01	Okeania	1435	36.45768092713284	28	0	28
1808	NZJI01	Cyanobium	83	53.76725977214371	3	0	3
1809	CACGJI01	Synechococcaceae	74	31.28177972291656	1	1	2
1810	MBQY01	Cylindrospermopsis	99	39.89855159248254	2	5	7
1811	DNYD01	Planktothrix	594	38.46998976170993	13	0	13
1812	QCSW01	Prochlorococcus	83	32.236644227340356	2	1	3
1813	QCBR01	Prochlorococcus	29	31.183533959271912	1	3	4
1814	CACNWD01	Prochlorococcus	45	30.822846343332913	2	1	3
1815	JFOD01	Prochlorococcus	139	30.46276808373493	0	3	3
1816	AANP01	Synechococcus	9	64.55433930079595	1	8	9
1817	QCBY01	Prochlorococcus	36	30.905366748708786	1	2	3
1818	DNGI01	Cyanobacteria	550	41.81346012697059	6	1	7
1819	CACHDE01	Prochlorococcus	45	32.07693595015855	1	1	2
1820	NSII01	Synechococcus	231	66.14073030680971	3	1	4
1821	CABZNT01	Prochlorococcus	39	31.104577887481508	2	1	3
1822	LXQE01	Nostoc	205	40.377612944325826	9	13	22
1823	QBZQ01	Prochlorococcus	52	31.76065648354448	1	1	2
1824	NRQW01	Fischerella	753	41.04266251268097	19	1	20
1825	NDHW01	Pseudanabaena	266	41.932107056308766	7	3	10
1826	QCBO01	Prochlorococcus	26	31.620105711883504	1	3	4
1827	QCML01	Prochlorococcus	36	31.39142266103233	1	3	4
1828	NKFP01	Leptolyngbya	8	51.14896019203354	0	6	6
1829	PBVK01	Cyanobium	137	61.535482699062	4	0	4
1830	CACHUV01	Synechococcaceae	46	31.74966185762407	0	0	0
1831	DNYY01	Cyanobacteria	510	40.29848155193089	7	0	7
1832	QCSJ01	Synechococcus	142	55.757901008193585	5	2	7
1833	DKOB01	Cyanobacteria	147	60.37384866284288	3	4	7
1834	QCBD01	Prochlorococcus	32	31.34278616668942	1	0	1
1835	QCMG01	Prochlorococcus	29	30.405191300245846	1	3	4
1836	LVHT01	Synechococcus	34	55.04319592746556	5	25	30
1837	QBZL01	Prochlorococcus	48	31.521513115159213	1	3	4
1838	PKDN01	Cyanobacterium	391	52.06657276494373	9	1	10
1839	CACBBI01	Prochlorococcus	57	31.41787192402165	1	1	2
1840	QCEP01	Prochlorococcus	45	32.22641436667986	2	2	4
1841	MKZS01	Moorea	13	43.827889832485205	0	29	29
1842	QCJS01	Prochlorococcus	30	38.45934094287342	1	2	3
1843	UCNI01	Synechococcus	14	58.826428488410784	0	5	5
1844	AAXW01	Crocosphaera	163	36.1708529528499	7	9	16
1845	QCTU01	Synechococcus	73	56.884752209404176	3	3	6
1846	PKRT01	Novosphingobium	3	64.3672604058101	1	3	4
1847	RPQW01	Chroococcales	878	41.713734629483895	20	0	20
1848	DMEQ01	Cyanobacteria	896	39.877030735238485	12	0	12
1849	QCJX01	Prochlorococcus	37	37.37475365034318	2	2	4
1850	QCTH01	Synechococcus	94	55.390362720252455	2	1	3
1851	ABRS01	Coleofasciculus	142	45.53904509911003	6	7	13
1852	QCJN01	Prochlorococcus	35	40.942435444055015	1	1	2
1853	LXYR01	Phormidesmis	213	49.26011350838262	2	4	6
1854	NJHT01	Cylindrospermopsis	414	40.29318842010294	5	5	10
1855	QCEF01	Prochlorococcus	23	30.979867440618186	2	1	3
1856	QCTC01	Prochlorococcus	75	30.916332581812465	2	2	4
1857	PYEQ01	Filamentous	907	56.21916977893486	5	0	5
1858	CACOPF01	Prochlorococcus	62	30.684877931716457	2	0	2
1859	DLEZ01	Cyanobacteria	54	35.64644358854418	0	0	0
1860	CAII01	Microcystis	892	42.27967243998056	18	0	18
1861	NQKZ01	Synechococcus	84	60.95761799550246	2	7	9
1862	RSCM01	Trichormus	54	40.415077287042	2	11	13
1863	CABYTO01	Prochlorococcus	43	31.8766565656842	1	3	4
1864	JFNH01	Prochlorococcus	222	30.886383812254753	0	1	1
1865	CABYJI01	Prochlorococcus	65	31.741336157166057	1	0	1
1866	PYCI01	Chroococcidiopsis	260	44.58517628235931	11	3	14
1867	LAHF01	Nostoc	566	41.75200031494939	24	3	27
1868	QCRP01	Prochlorococcus	47	40.421041023186	0	1	1
1869	QCCU01	Prochlorococcus	42	32.13306229782801	2	2	4
1870	JFNC01	Prochlorococcus	381	31.21135626536536	0	2	2
1871	QCLV01	Prochlorococcus	40	32.10925229209552	1	3	4
1872	MWLD01	Candidatus	84	60.30285138516725	1	0	1
1873	CACGKN01	Prochlorococcus	46	31.83079218414511	1	1	2
1874	NOXW01	Rhodoferax	22	60.77901422541971	0	2	2
1875	CACAXR01	Prochlorococcus	39	31.08084145969564	2	1	3
1876	PEBC01	Cyanobacterium	124	35.17052950825603	3	5	8
1877	DNXU01	Cyanobacteria	642	45.712815990910265	16	0	16
1878	LAGX01	Nostoc	187	41.99363776373437	10	12	22
1879	PDDM01	Pseudanabaena	88	41.61062351429322	1	7	8
1880	QCRF01	Prochlorococcus	51	31.435024114610105	2	1	3
1881	PRLH01	Cyanothece	227	37.90893174848945	8	1	9
1882	QCCC01	Prochlorococcus	50	31.66525094156243	2	1	3
1883	CABYTR01	Prochlorococcus	17	35.518168232861036	0	0	0
1884	CACNVU01	Prochlorococcus	51	31.789608908803917	1	2	3
1885	JFNU01	Prochlorococcus	237	30.33835416667229	0	2	2
1886	QCCH01	Prochlorococcus	30	31.933626848268215	1	3	4
1887	QCRM01	Prochlorococcus	73	31.138727962101523	2	0	2
1888	CACILY01	Prochlorococcus	59	36.03032554473853	3	1	4
1889	CACLDO01	Synechococcaceae	27	32.40705614954643	1	0	1
1890	CABZHQ01	Prochlorococcus	47	31.359814445518513	1	3	4
1891	JXUO01	Candidatus	326	57.80528772114771	3	0	3
1892	JAADAT01	Microcystis	456	42.98225903310935	14	1	15
1893	QCUY01	Synechococcus	107	52.08984209296632	3	0	3
1894	CACFEJ01	Prochlorococcus	44	31.814657264422667	3	0	3
1895	DPLL01	Microcoleaceae	553	44.94933187972516	2	0	2
1896	SYAQ01	Prochlorococcus	580	69.51559137291223	18	0	18
1897	QBMQ01	Phormidesmis	84	48.60075671150322	5	4	9
1898	AVFU01	Planktothrix	274	38.908852094270046	8	2	10
1899	ASAK01	Planktothrix	13	39.884945255621275	0	11	11
1900	CACLCP01	Synechococcaceae	13	30.02757069459613	0	0	0
1901	QCDW01	Prochlorococcus	30	31.704267898445213	1	3	4
1902	NHER01	Synechococcus	87	59.3004738327367	2	5	7
1903	LJOP01	Anabaena	122	38.167030731045344	8	6	14
1904	QCUR01	Prochlorococcus	16	29.1433292592695	0	4	4
1905	QCKB01	Prochlorococcus	18	39.92415021097915	0	5	5
1906	JAADAI01	Microcystis	634	42.75663832454314	13	1	14
1907	QCUD01	Prochlorococcus	70	31.267003973051175	3	0	3
1908	MUGG01	Alkalinema	223	50.54528339438869	0	7	7
1909	QBML01	Pseudanabaena	67	41.913763474441915	2	4	6
1910	CACBDL01	Prochlorococcus	35	30.895190702969824	0	3	3
1911	MRCF01	Scytonema	179	43.674565881063735	14	17	31
1912	DDVE01	Cyanobacteria	41	49.639066759351984	1	3	4
1913	QBMG01	Cyanobium	124	66.31232965693019	4	7	11
1914	PCGE01	Synechococcus	62	48.71084374448552	0	4	4
1915	QCUO01	Prochlorococcus	46	34.93936235285202	2	3	5
1916	QVFV01	Halomicronema	16	54.15782381855386	1	3	4
1917	QCDJ01	Prochlorococcus	52	31.546373555752194	2	2	4
1918	QCKI01	Prochlorococcus	14	43.74356091961214	1	0	1
1919	RFIF01	Cyanobacteria	626	56.17852133726428	3	0	3
